asn,google_total_hits,facebook_total_hits,wikipedia_total_hits,imgur_total_hits,youtube_total_hits,total_hits
1,463,2,0,8,52,525
100,0,0,0,0,0,0
10000,316,1,0,0,0,317
10003,5699,39,6,2,1088,6834
10004,0,0,0,1,0,1
10006,0,1,0,0,0,1
10010,37272,2603,814,66,2958,43713
10011,3355,1,0,4,369,3729
10013,879,25,110,19,660,1693
10014,1,1,8,1,0,11
10019,6003,198,0,3,1227,7431
10021,1,0,0,0,0,1
10022,283,62,0,0,59,404
10024,1171,54,0,1,117,1343
10029,3471,542,191,90,162,4456
10030,0,3808,145,222,967,5142
10036,4319,12,2,7,894,5234
10037,6,0,0,0,94,100
10045,0,0,0,1,12,13
10049,0,0,0,0,0,0
10052,1228,0,26,2,26,1282
10054,36,0,2,0,1,39
10060,0,0,0,0,0,0
10066,474,0,0,0,240,714
10085,685,13,0,19,0,717
10088,8,1,0,0,0,9
10094,5652,3081,394,177,1819,11123
10098,528,2,0,0,9,539
10099,3101,14,58,61,97,3331
10101,501,4,8,1,103,617
10103,10440,305,1958,111,1765,14579
10118,4930,4,73,21,1090,6118
10126,8,0,0,1,0,9
10132,3054,1,0,3,135,3193
10137,878,19,87,0,159,1143
10139,14636,491,3833,151,7134,26245
10143,1140,862,366,22,1056,3446
10162,23,0,0,0,0,23
10164,3291,1,0,0,2,3294
10174,0,0,0,0,0,0
10175,0,0,0,0,0,0
10176,1,0,0,0,0,1
10194,978,0,39,0,1,1018
10197,147,0,0,0,1,148
10199,380,80,0,3,1,464
10212,5,0,0,0,0,5
10214,286,273,40,19,286,904
10217,5,213,121,11,0,350
10222,415,1,0,9,49,474
10225,0,44,82,5,0,131
10226,2813,1,2,12,230,3058
10242,0,0,0,0,0,0
10249,0,0,361,1,0,362
10279,296,0,0,0,0,296
103,0,0,0,0,0,0
10318,11301,2804,1649,316,3430,19500
10326,0,0,0,0,0,0
10352,16,0,98,0,0,114
10361,163,5,0,3,15,186
10364,0,0,0,0,0,0
10367,0,1,388,12,0,401
10384,0,0,0,0,0,0
10392,0,0,0,0,0,0
104,0,0,0,0,0,0
10412,557,4,144,6,2,713
10421,0,0,0,0,0,0
10423,0,0,0,0,0,0
10429,50379,5722,2147,914,16174,75336
10430,3198,61,11,1,414,3685
10439,0,0,0,0,0,0
10448,0,0,0,0,0,0
10455,0,0,0,0,0,0
10481,10201,2821,1166,251,2117,16556
10507,865,6,0,0,2,873
10508,0,0,0,0,0,0
10546,0,0,0,0,0,0
10594,842,25,147,28,271,1313
10617,3546,616,289,52,97,4600
10631,0,0,0,0,0,0
10670,169,0,0,0,1,170
10674,0,0,0,0,1,1
10689,0,0,0,0,0,0
10695,0,0,0,0,0,0
10697,2,1,18,0,0,21
10750,0,0,0,0,0,0
10753,542,76,15,15,0,648
10755,0,0,0,0,0,0
10778,608,196,288,3,112,1207
10796,161070,2106,15586,1354,47641,227757
10821,0,0,0,0,0,0
10834,3039,1650,1033,76,575,6373
10835,649,13,36,7,341,1046
10837,0,0,0,0,0,0
10838,25,2,157,8,0,192
10865,489,8,22,0,160,679
10879,0,0,0,0,0,0
10881,1455,35,58,6,27,1581
10882,0,0,189,19,0,208
109,549,3,0,0,58,610
10929,2025,114,74,3,311,2527
10947,1401,19,75,0,363,1858
10952,0,0,0,0,0,0
10954,1541,92,143,11,7,1794
10958,0,0,0,0,0,0
10967,247,1,0,0,11,259
10971,0,0,0,0,0,0
10973,544,5,31,4,229,813
10980,355,0,13,0,11,379
10991,0,0,0,1,0,1
10993,0,0,4,0,31,35
10996,2021,22,54,6,174,2277
1101,0,0,0,0,0,0
11014,3954,1391,486,234,550,6615
11015,0,0,0,0,0,0
1103,508,0,315,0,181,1004
11030,140,0,0,0,12,152
11038,852,70,160,37,396,1515
11039,1,0,0,0,0,1
11042,0,0,0,0,0,0
11045,266,2,26,2,35,331
11046,175,4,63,0,32,274
11050,0,0,0,0,0,0
11062,0,0,8,0,0,8
11071,2838,22,16,8,661,3545
11078,0,0,0,0,0,0
11080,619,7,2,1,97,726
11094,0,0,0,0,0,0
111,0,0,0,0,0,0
11109,0,0,0,0,0,0
11114,307,0,0,0,8,315
11118,10,0,10,0,0,20
11123,0,0,18,7,0,25
11126,0,0,0,0,0,0
11127,0,1,2,0,0,3
11138,0,0,0,0,0,0
11142,0,0,0,0,0,0
11152,0,0,0,0,0,0
11172,0,0,0,0,0,0
11178,2,0,38,0,0,40
11183,0,0,0,0,0,0
11191,4438,645,562,47,2316,8008
11195,579,7,125,1,251,963
11197,0,0,0,0,0,0
11203,384,116,6,0,94,600
11206,0,0,0,0,0,0
11214,0,0,0,0,0,0
11215,0,0,0,0,0,0
11232,0,0,0,0,1,1
11233,659,35,12,0,243,949
11240,0,0,0,0,0,0
11245,0,0,0,0,0,0
11252,0,0,0,0,0,0
11260,36991,1576,1725,74,9063,49429
11269,0,0,15,0,0,15
11272,22,0,0,0,0,22
11279,54,0,0,0,0,54
11283,33,0,0,0,8,41
11290,17004,1375,845,26,7167,26417
11315,375,12,0,10,168,565
11318,178,0,0,0,0,178
11320,0,0,0,0,0,0
1133,0,0,0,0,0,0
11338,2921,2,141,22,364,3450
11340,137,87,26,1,4,255
11348,0,0,0,0,0,0
11351,4168,17,8699,324,1,13209
11353,0,0,0,0,0,0
1136,0,0,1758,0,0,1758
11381,545,3,68,42,174,832
11404,21683,2095,1659,266,11192,36895
11414,3,0,0,7,2,12
11417,0,0,0,0,0,0
11419,1989,50,143,29,72,2283
11426,81248,1900,10382,924,38712,133166
11427,163,0,0,12,0,175
11432,4484,190,430,196,2407,7707
11442,717,1,0,0,8,726
11448,0,0,0,0,0,0
11452,0,0,0,0,0,0
11472,405,1,0,0,5,411
11478,2359,286,34,7,312,2998
11486,0,0,0,0,0,0
11492,54837,278,335,361,6829,62640
11514,107,53,0,14,11,185
11524,0,0,320,2,0,322
11525,0,0,0,0,0,0
11536,0,0,0,0,0,0
11550,0,0,102,0,0,102
11577,0,0,0,0,0,0
11584,0,0,0,0,0,0
11589,0,0,0,3,0,3
11590,118,0,0,0,0,118
11594,0,0,0,0,0,0
11597,0,0,0,0,0,0
11601,602,2,22,1,21,648
11606,0,2,56,1,0,59
11607,0,0,0,0,0,0
11620,371,155,91,4,115,736
11623,25,0,6,0,0,31
11624,720,2,32,2,27,783
11649,112,4,0,0,0,116
11650,0,0,0,0,0,0
11659,0,0,0,0,0,0
11663,63,1,0,0,0,64
11664,5992,2102,930,123,1125,10272
11668,0,0,4,0,0,4
11681,1112,23,82,17,380,1614
11686,268,1,121,0,4,394
11691,337,5,0,11,83,436
11693,1,0,0,0,0,1
11698,0,0,0,0,0,0
11708,0,0,0,0,0,0
11711,0,0,0,0,0,0
11714,0,0,0,0,0,0
11722,1842,102,568,0,710,3222
11727,913,29,0,4,236,1182
11738,0,0,0,0,0,0
11741,697,1,0,3,60,761
11745,0,0,0,0,0,0
11763,0,0,0,0,0,0
11776,61186,315,4640,176,12658,78975
11796,2,0,28,0,0,30
11802,1124,5,249,5,79,1462
11808,216,0,0,0,0,216
11809,0,0,0,0,0,0
11814,209,0,2,0,6,217
11815,720,538,161,81,291,1791
11827,477,2,0,2,123,604
11831,124,2,0,0,73,199
11834,0,0,0,3,0,3
11835,4997,25,447,18,314,5801
11844,2404,5,551,3,233,3196
11847,78,3,832,9,0,922
11870,276,0,0,0,0,276
11872,0,0,0,0,0,0
11878,0,0,0,0,0,0
11888,0,0,0,0,0,0
11904,0,0,0,0,0,0
11910,0,0,0,0,0,0
11915,23,0,0,0,0,23
11921,57,53,8,2,1,121
11924,1806,34,72,14,447,2373
11949,0,0,0,0,0,0
11955,0,0,0,0,0,0
11961,0,0,0,0,0,0
11970,0,0,0,0,0,0
11971,7,0,0,0,0,7
11975,155,0,0,0,0,155
11976,0,0,0,0,0,0
11979,0,0,0,0,0,0
11993,177,0,0,0,0,177
11994,1396,298,48,22,428,2192
11995,127,0,0,0,0,127
11998,0,0,0,0,0,0
12,0,0,2,0,0,2
12005,2,0,0,0,0,2
12009,1205,84,417,12,558,2276
1201,0,0,0,0,0,0
12013,0,0,0,0,0,0
12019,0,0,0,0,0,0
12025,1,0,0,4,0,5
12033,0,0,37,0,0,37
12042,0,0,0,0,0,0
12044,621,4,24,1,123,773
12046,105,5,0,2,5,117
12054,31,0,0,0,0,31
12056,1,0,139,4,0,144
12067,0,0,0,0,0,0
12069,200,0,35,1,42,278
12079,0,0,0,0,0,0
12083,2002,8,457,0,128,2595
12089,0,0,0,0,0,0
12094,0,1,237,11,0,249
12097,0,0,0,0,0,0
12118,786,1,0,0,18,805
12119,0,0,0,0,0,0
12129,0,0,0,0,0,0
1213,5422,366,98,0,400,6286
12132,608,19,29,6,208,870
12133,0,0,0,0,0,0
12135,574,4,282,0,160,1020
12145,0,0,0,0,0,0
12148,0,0,0,0,0,0
1215,2,0,0,0,0,2
12150,841,105,101,4,22,1073
12155,0,0,0,0,0,0
12173,0,0,0,0,0,0
12175,3636,42,134,41,628,4481
12177,0,0,0,0,0,0
12182,5,1,0,0,0,6
12183,247,6,125,21,92,491
12191,0,0,0,0,0,0
122,90,1,0,0,0,91
12208,57,0,49,0,1,107
1221,96553,8556,2283,923,58196,166511
12217,0,0,0,0,0,0
12231,8,0,0,0,0,8
12241,0,0,0,0,0,0
12257,0,0,0,0,0,0
1226,829,11,0,0,96,936
12261,0,0,8,0,0,8
12271,1908,26,10240,541,3,12718
12282,1,0,55,1,0,57
12285,0,0,0,0,0,0
12302,13,0,346,1,463,823
12310,4358,70,676,9,189,5302
12312,9137,455,684,0,211,10487
12322,1164,0,334,2,77,1577
12329,1172,16,99,3,104,1394
12334,0,0,118,4,333,455
12337,293,0,103,0,12,408
12338,26,0,98,5,188,317
12346,0,0,271,0,0,271
12350,312,0,416,1,609,1338
12353,143,0,33,0,187,363
12355,2435,43,242,0,18,2738
12357,0,0,0,0,12,12
12360,2555,19,250,12,263,3099
12361,0,0,8,1,220,229
1237,47,0,0,0,2,49
12386,0,0,76,0,0,76
12389,2539,2317,2347,49,658,7910
1239,3543,10,201,11,347,4112
12390,0,0,62,0,0,62
12392,0,0,467,0,0,467
12399,1135,34,76,4,22,1271
12406,2333,35,61,7,165,2601
1241,183,0,225,0,1049,1457
12414,0,0,101,0,0,101
12418,0,0,0,0,0,0
12426,77,0,23,0,2,102
12430,2403,0,925,0,2012,5340
12443,2,1,0,0,1,4
12445,1023,30,0,7,62,1122
12453,219,2,57,0,0,278
1246,14,0,160,2,0,176
12479,1588,0,1257,9,2832,5686
12481,713,40,70,13,78,914
1249,0,0,2,0,0,2
12508,0,1,14,0,0,15
12513,197,0,11,0,44,252
12519,0,0,26,0,0,26
12541,0,0,0,0,0,0
12552,20269,942,2725,54,3295,27285
12564,0,0,0,1,154,155
1257,27482,1039,1968,57,4440,34986
12570,0,1,285,0,65,351
12576,680,0,102,0,60,842
12578,7267,401,2485,49,5585,15787
12586,2067,11,180,0,377,2635
12597,1276,0,26,0,34,1336
12605,11,0,399,13,2727,3150
12611,5125,74,418,3,344,5964
12615,444,0,321,1,1020,1786
12618,0,0,0,0,0,0
12620,0,0,93,0,108,201
12626,0,0,23,0,9,32
12629,0,0,4,0,0,4
12663,252,0,0,0,0,252
12668,0,1,27,0,0,28
1267,72128,4252,1510,132,22606,100628
12670,205,0,19,0,1,225
12683,0,6,0,0,47,53
12684,2450,8,607,0,77,3142
12693,5283,197,1018,3,576,7077
12695,0,1,6,0,0,7
12703,0,0,0,0,0,0
12708,0,0,30,0,0,30
12709,25457,204,1567,52,2180,29460
12714,285,661,431,18,109,1504
12722,0,9,73,0,0,82
1273,500,31,217,2,0,750
12730,287,58,2,0,0,347
12734,65,0,0,0,0,65
12739,0,0,0,0,0,0
12741,0,0,146,0,0,146
12759,2088,44,187,0,141,2460
12767,0,0,216,0,69,285
12772,287,6,8,0,0,301
12779,884,10,153,12,44,1103
12782,59,0,0,0,1,60
12793,4943,104,396,8,123,5574
12810,6028,565,979,11,589,8172
12816,2432,1,467,0,243,3143
12829,40,0,151,2,453,646
12831,0,0,4,0,0,4
12835,966,58,52,17,18,1111
12843,3384,16,189,14,294,3897
12850,2083,25,338,3,35,2484
12859,0,0,249,0,0,249
12874,26118,987,2932,127,5666,35830
12876,1,0,4,39,190,234
12886,0,0,286,1,309,596
1289,0,0,0,0,0,0
12897,9294,82,427,7,289,10099
12905,77,0,80,0,8,165
12907,195,0,39,2,58,294
12929,863,2,173,0,452,1490
1294,0,0,0,0,0,0
12941,740,0,50,0,10,800
12942,0,0,0,0,0,0
12946,1,0,213,0,65,279
12958,0,36,26,1,2,65
12989,105,34,0,4,37,180
1299,543,8,49,2,112,714
12993,0,4,0,0,0,4
13009,0,0,6,0,0,6
13012,579,0,0,0,5,584
13030,1516,0,52,8,882,2458
13036,174,0,773,5,99,1051
13037,1072,0,208,5,0,1285
13041,4,0,0,0,3,7
13043,3,0,71,0,0,74
13045,5433,47,703,1,425,6609
13046,5449,129,678,6,144,6406
13055,0,14,24,0,0,38
13056,76,1,98,0,0,175
13070,65,0,0,0,8,73
13091,1,0,364,4,650,1019
13092,2215,207,189,1,78,2690
13097,4010,44,163,21,88,4326
131,0,0,0,0,0,0
13101,0,0,112,0,0,112
13105,9,1,0,0,0,10
131090,18523,4664,574,210,6629,30600
131111,6682,1773,662,96,1993,11206
13113,5389,27,662,5,488,6571
131178,825,260,152,8,559,1804
13118,26,3,2,1,0,32
13119,0,0,112,0,0,112
1312,356,1,0,0,3,360
131207,5216,1600,705,59,1765,9345
131210,614,192,24,17,29,876
131215,1722,716,337,109,442,3326
13122,0,0,518,0,0,518
13124,139,0,742,16,3095,3992
131267,3335,64,422,66,1873,5760
131269,1,3269,84,232,0,3586
13127,0,0,500,0,0,500
131285,933,44,0,5,4,986
131293,1793,1313,237,7,355,3705
131303,1198,4,50,2,68,1322
131306,434,2,4,16,49,505
131365,0,0,0,0,0,0
131385,150,0,0,2,3,155
131429,3497,621,148,92,959,5317
131442,1236,663,378,57,254,2588
131445,3412,963,65,152,2026,6618
131459,64,12,117,0,7,200
131463,136,41,0,3,10,190
131467,73,0,0,0,0,73
131476,649,176,144,0,88,1057
13150,453,23,4,10,11,501
13156,0,0,2,1,38,41
131584,2823,18,10,80,0,2931
131591,2401,47,12,4,3,2467
131596,24163,468,263,437,197,25528
131597,1499,32,25,30,0,1586
131600,5,3,0,0,0,8
131607,1217,18,4,28,0,1267
131627,7060,98,50,103,5,7316
13170,1701,147,133,1,31,2013
131706,921,226,250,5,438,1840
131711,852,151,224,2,279,1508
131713,449,23,87,1,122,682
131717,1532,506,372,10,523,2943
131722,8,5,0,0,1,14
131724,109,0,0,0,65,174
131735,280,47,134,1,48,510
131738,19,1,0,0,1,21
13174,0,1,72,0,0,73
131740,522,138,85,2,230,977
131743,132,1,0,0,0,133
131745,647,225,177,6,404,1459
131746,128,9,0,0,38,175
131749,575,262,57,1,180,1075
131754,0,0,0,0,0,0
131759,572,10,112,0,123,817
131767,352,6,6,2,25,391
131769,1497,549,151,21,766,2984
131773,88,2,130,4,5,229
131776,155,6,0,0,4,165
13178,0,1,0,0,0,1
13182,748,5,102,1,62,918
13189,6235,97,274,7,1645,8258
131897,567,3,6,0,9,585
131907,449,3,0,2,50,504
131911,0,0,0,0,0,0
131915,0,0,0,0,0,0
131916,0,0,0,0,0,0
131918,0,0,0,1,0,1
131920,376,1,0,6,132,515
131921,1,1,0,1,0,3
131923,1,1,0,0,0,2
131925,2387,21,6,24,1145,3583
131926,0,0,0,0,6,6
131928,509,0,0,0,11,520
13193,0,0,18,0,3,21
131931,3,0,2,0,0,5
131934,311,0,0,0,0,311
13194,1337,46,352,19,571,2325
131943,862,22,0,33,327,1244
131949,951,61,6,0,192,1210
131952,0,1,11,1,0,13
131958,2,3,0,0,63,68
131970,570,0,0,0,117,687
132021,676,52,219,30,351,1328
132035,0,137,0,0,0,137
132054,564,1,127,0,133,825
132061,336,4355,82,400,0,5173
132080,710,124,41,6,206,1087
132113,285,67,0,0,189,541
13213,164,2,263,10,67,506
132137,2681,797,961,80,529,5048
132196,0,1,0,0,0,1
132199,15955,952,3993,537,17942,39379
132203,30446,370,188,969,4524,36497
132215,280,86,118,10,13,507
132220,2458,1206,191,162,972,4989
132280,0,528,75,8,0,611
132296,2635,950,754,127,830,5296
132335,113,240,9,6,20,388
132356,30,103,0,0,8,141
13237,5520,219,922,17,89,6767
132372,0,7,54,0,0,61
132400,863,16,264,27,282,1452
132423,68,58,0,13,1,140
13243,1075,13,100,0,11,1199
132445,613,298,92,17,60,1080
132453,0,0,0,0,0,0
132454,435,0,217,0,2,654
132497,1413,485,689,63,225,2875
132508,5,0,0,0,8,13
132513,0,0,2,0,0,2
132515,44,8,69,1,4,126
132518,215,14,20,0,7,256
132519,334,63,0,6,28,431
132523,67,16,13,3,8,107
132524,0,0,0,0,0,0
132525,284,3,6,0,8,301
132529,543,252,71,21,323,1210
132547,540,179,116,26,118,979
132556,320,529,757,45,74,1725
132559,0,71,154,5,0,230
132562,24,74,27,1,0,126
132566,299,81,244,11,30,665
132570,282,169,141,14,126,732
132573,782,161,318,15,77,1353
132585,5481,44,217,49,157,5948
132590,559,171,0,1,145,876
132597,144,1,0,6,23,174
132599,275,129,46,0,53,503
132615,1549,49,268,0,72,1938
132618,0,399,30,26,0,455
132637,716,226,143,22,277,1384
132641,456,47,63,1,10,577
132649,135,8,76,0,16,235
132652,732,425,259,12,419,1847
132653,568,122,143,13,399,1245
132669,287,59,144,4,102,596
132676,276,41,0,7,9,333
132688,0,96,0,4,0,100
13272,1027,15,23,1,193,1259
132730,813,132,142,3,126,1216
132751,477,141,268,14,68,968
132752,574,349,287,47,399,1656
132761,568,375,283,25,197,1448
132764,85,16,143,1,12,257
132768,543,256,294,12,120,1225
132770,7174,3800,3802,444,2751,17971
132774,0,520,240,71,0,831
132785,65,1,116,0,1,183
132787,0,7,44,0,0,51
13280,11977,1380,692,12,4337,18398
132839,4146,2,0,25,72,4245
13285,1268,0,245,17,390,1920
132882,0,98,0,0,0,98
132890,0,25,13,0,0,38
13292,515,10,0,0,8,533
132923,1400,814,584,74,365,3237
132924,0,244,80,24,0,348
132931,0,8,0,0,0,8
132933,1960,661,995,79,746,4441
132935,258,75,89,8,16,446
132956,1,30,2,13,16,62
132957,202,15,0,3,53,273
132958,286,30,144,12,93,565
132961,0,20,2,1,0,23
132964,325,251,229,4,27,836
132971,276,46,19,16,42,399
132972,285,120,116,13,132,666
132976,1467,1020,608,115,735,3945
132988,267,77,141,13,181,679
132996,1388,585,714,51,552,3290
133000,0,110,150,2,0,262
133001,3186,1218,1456,167,977,7004
133007,426,138,287,11,139,1001
133014,0,214,58,12,0,284
13303,0,0,19,16,451,486
13306,0,0,4,0,23,27
133070,858,372,317,28,344,1919
133073,273,1,0,2,4,280
133107,861,9,12,5,98,985
133115,1896,34,4,5,128,2067
133119,87,10,0,0,0,97
133125,84,12,0,0,0,96
133226,735,177,319,17,97,1345
133234,922,643,419,70,310,2364
133235,28,6,114,0,2,150
133237,170,22,66,3,32,293
133243,287,138,130,17,139,711
133244,38,32,0,1,19,90
133246,930,350,425,42,262,2009
133249,245,88,144,6,91,574
133255,2040,863,1087,96,654,4740
133257,286,225,141,21,164,837
13326,0,0,0,0,0,0
133269,223,42,112,5,9,391
13327,0,0,0,0,0,0
133287,285,533,12,48,243,1121
13329,0,0,0,0,0,0
133296,305,82,141,11,87,626
133301,842,345,397,19,322,1925
133304,251,103,141,7,89,591
133309,456,296,359,26,101,1238
133311,2337,1186,1411,120,825,5879
133315,893,200,270,29,88,1480
13333,4898,872,344,21,1011,7146
133333,548,218,0,1,268,1035
133334,2403,26,740,47,480,3696
13335,1810,727,50,59,865,3511
133352,254,17,0,0,33,304
133354,410,21,96,3,32,562
133360,242,120,126,2,178,668
13337,0,0,0,0,0,0
133380,1468,15,10,36,227,1756
133389,654,59,0,7,257,977
133398,300,1,0,6,10,317
133408,0,70,0,1,0,71
133414,6439,280,9,15,4727,11470
133421,288,1,72,0,0,361
133449,5,5,0,0,1,11
133469,1218,363,288,32,101,2002
133480,519,306,6,36,455,1322
133481,11595,8323,577,589,5932,27016
13351,0,0,0,0,0,0
133527,117,0,0,5,5,127
13353,519,155,0,4,25,703
13356,0,0,0,0,0,0
13357,478,5,0,7,30,520
133590,435,199,287,29,156,1106
133597,1,5,78,0,0,84
133598,109,86,143,16,61,415
133612,6028,843,138,294,5384,12687
133613,6550,128,1278,103,1557,9616
133623,827,3,127,4,323,1284
133647,24,4,0,0,30,58
133658,229,44,143,7,16,439
133660,0,271,143,28,0,442
133662,346,134,144,17,113,754
133674,487,240,284,22,216,1249
133678,0,191,78,8,0,277
133679,269,158,93,17,54,591
13368,0,0,0,0,0,0
133680,0,15,74,6,0,95
133684,272,120,0,8,22,422
133685,0,233,150,14,0,397
133695,845,327,345,21,217,1755
13370,4217,514,1532,41,2624,8928
13371,0,0,0,0,0,0
133713,107,48,193,11,3,362
133720,4114,1719,1858,204,1253,9148
133724,318,60,15,6,143,542
133726,252,108,143,16,54,573
133730,562,301,78,7,298,1246
133736,1913,806,339,29,848,3935
133752,1521,4,4,49,196,1774
133762,130,2,0,3,53,188
133774,1715,348,11,26,176,2276
133775,1053,5,0,0,3,1061
133797,188,2,0,0,1,191
133798,540,46,10,1,89,686
133799,224,1,0,1,3,229
133800,2072,258,387,18,443,3178
133809,574,31,8,10,82,705
13381,238,148,0,6,22,414
133811,526,24,0,0,63,613
133815,569,274,177,7,83,1110
133817,155,5,0,0,6,166
133819,116,48,0,0,37,201
133823,788,26,47,7,275,1143
13388,1,0,0,0,0,1
13392,0,0,0,0,0,0
133929,1778,23,40,66,130,2037
133968,567,345,261,53,233,1459
133971,2,87,78,7,0,174
133977,340,157,378,34,67,976
133982,1722,1131,311,151,557,3872
133983,80,22,31,1,13,147
133994,284,145,123,26,55,633
133996,8,6,15,1,2,32
133997,926,437,534,35,395,2327
134000,643,308,261,31,214,1457
134004,774,157,185,22,62,1200
134005,267,108,2,13,70,460
134006,1373,557,726,73,441,3170
134008,513,210,143,30,65,961
134009,572,402,282,32,317,1605
134012,287,117,10,20,54,488
134014,1056,424,448,53,267,2248
134016,0,9,0,0,0,9
134019,52,1,0,0,0,53
134021,0,245,72,19,27,363
134022,1136,639,226,90,397,2488
134032,52,466,316,29,0,863
134033,35,632,327,81,71,1146
134041,0,0,0,0,0,0
134042,1036,442,422,54,211,2165
134047,286,258,143,20,190,897
134052,163,149,76,13,0,401
134053,1727,930,823,85,506,4071
134054,0,121,78,8,0,207
134055,563,359,284,36,290,1532
134059,307,47,227,11,54,646
134067,1873,666,139,50,1169,3897
134078,2151,576,247,17,258,3249
134090,572,293,153,89,540,1647
134100,1,47,0,0,0,48
134139,1419,1350,545,58,899,4271
134141,1583,853,31,3,238,2708
13415,0,0,13,1,13,27
134166,2,8,0,0,17,27
134196,9,0,0,0,2,11
134238,408,19,0,0,0,427
134254,1088,426,506,35,215,2270
134256,78,90,28,11,17,224
134257,362,92,143,0,25,622
134258,286,194,141,18,119,758
134260,0,12,56,3,0,71
134262,286,149,139,16,145,735
134265,298,114,177,16,59,664
134269,15,31,98,1,1,146
13427,1076,16,2,0,371,1465
134273,219,33,0,4,31,287
134274,123,20,105,4,16,268
134277,24,96,0,0,1,121
134278,384,156,258,26,61,885
13428,0,0,164,1,0,165
134280,56,26,54,1,8,145
134290,286,126,143,6,133,694
134293,763,209,311,20,278,1581
134304,308,99,161,19,60,647
134305,0,234,219,21,0,474
134307,527,123,44,22,146,862
134312,791,163,418,15,90,1477
134313,284,125,143,28,152,732
134316,0,34,0,0,0,34
134325,547,47,141,18,20,773
134326,83,469,255,31,0,838
134329,480,147,139,20,45,831
134331,1511,593,188,60,276,2628
134334,287,68,114,6,39,514
134343,661,205,107,45,123,1141
134366,137,0,0,2,5,144
134419,1185,4,0,0,0,1189
134420,861,28,6,0,0,895
134431,1167,3,146,2,68,1386
134451,411,342,6,29,116,904
13451,866,71,140,9,586,1672
134520,1172,28,0,32,161,1393
134540,1413,643,253,32,299,2640
134543,1399,10,28,6,30,1473
134548,10858,38,468,91,708,12163
134553,0,304,35,4,0,343
134564,271,201,2,1,84,559
134630,403,94,107,4,31,639
134635,8,2,4,0,0,14
134639,256,30,78,0,8,372
134641,27,4,17,0,2,50
134643,369,35,98,2,46,550
134648,360,39,139,4,150,692
134651,99,33,80,3,49,264
134655,1093,243,209,27,513,2085
134674,931,892,580,63,339,2805
134687,567,0,10,0,21,598
134697,1716,1137,463,113,1271,4700
134707,1675,178,339,77,1202,3471
134710,415,1,6,0,9,431
134711,286,283,143,28,288,1028
13476,205,0,0,0,3,208
134760,10,13,0,0,0,23
134762,927,244,2,0,14,1187
134764,512,32,15,0,8,567
134768,1295,154,0,0,1,1450
134771,738,142,2,8,26,916
134772,9591,1545,410,17,613,12176
134773,26190,3841,1149,114,2179,33473
134775,1333,184,148,3,10,1678
134802,533,15,130,8,171,857
134809,0,526,76,1,0,603
134810,461,73,2,0,220,756
134829,256,0,0,0,2,258
13485,0,0,2,0,0,2
134850,222,57,141,9,25,454
134855,689,171,283,22,173,1338
134861,44,1,0,0,0,45
134862,0,0,0,0,0,0
134863,0,1,0,1,0,2
134866,186,42,276,2,22,528
134869,1,173,74,10,0,258
134870,364,243,143,23,151,924
134871,285,79,56,10,57,487
134873,0,149,0,23,49,221
134875,444,88,141,32,29,734
134877,0,1054,434,103,0,1591
134878,0,121,36,18,0,175
134881,223,54,0,8,30,315
134883,211,42,113,7,39,412
134885,254,188,146,12,81,681
134886,274,84,108,10,73,549
134892,0,83,76,7,0,166
134897,70,8,9,4,5,96
134899,623,116,173,24,43,979
13490,0,0,0,0,0,0
134903,0,56,46,0,0,102
134907,250,112,92,12,5,471
134911,0,18,0,0,0,18
134913,1146,863,572,89,624,3294
134916,261,33,168,0,33,495
134918,0,165,143,15,0,323
134922,572,358,283,31,211,1455
134929,571,246,290,22,115,1244
134933,195,13,4,0,24,236
134937,814,303,308,45,210,1680
134942,244,68,138,9,72,531
134980,0,0,0,0,0,0
134996,700,8,191,2,19,920
135025,1916,26,351,3,439,2735
135034,572,184,2,0,124,882
135036,550,225,282,40,364,1461
135060,1685,1285,663,18,828,4479
135061,13,1,0,0,0,14
1351,44,0,13,0,0,57
13512,438,2,2,6,57,505
135126,1609,1147,576,130,1099,4561
135139,0,519,236,39,97,891
135177,287,132,76,23,69,587
135180,266,57,141,8,45,517
135182,0,1,0,0,0,1
135184,287,163,144,17,130,741
135189,333,274,225,30,178,1040
135202,0,18,94,7,0,119
135206,0,80,80,4,0,164
135207,208,48,143,7,54,460
135212,0,0,0,0,0,0
135214,264,124,137,9,27,561
135215,36,2,0,1,1,40
135216,0,138,18,9,0,165
135217,884,481,324,38,163,1890
135218,168,85,128,10,8,399
135225,0,343,230,23,0,596
135227,235,78,76,4,6,399
135232,0,84,0,0,0,84
135234,284,201,143,9,155,792
135239,879,575,569,50,436,2509
135241,302,128,0,13,63,506
135242,1,78,141,6,0,226
135244,0,376,386,47,0,809
135247,1,745,301,55,0,1102
135256,300,191,21,1,83,596
135257,1116,524,572,60,421,2693
135259,249,81,0,7,25,362
135261,378,179,284,32,157,1030
135262,12,0,0,0,0,12
135267,460,117,282,5,45,909
135269,528,305,141,37,253,1264
135330,717,14,0,35,160,926
135333,265,13,4,4,5,291
13534,0,0,0,0,0,0
135345,1737,33,258,2,599,2629
135356,1040,98,8,34,67,1247
13536,65,3,1221,28,0,1317
135360,11,0,0,0,0,11
135366,395,3,105,0,82,585
135373,1464,7,56,57,77,1661
135375,163,13,62,0,1,239
135377,510,19,6,6,5,546
135386,1068,6,2,20,6,1102
135391,2456,11,21,24,105,2617
135409,1613,139,214,3,541,2510
135423,409,3,6,3,61,482
135449,294,32,128,2,65,521
135450,91,30,0,0,52,173
135459,106,6,40,0,30,182
135464,287,35,0,14,69,405
135465,52,23,0,0,5,80
135468,345,64,11,0,79,499
135471,254,73,101,1,34,463
135474,448,60,86,12,165,771
135477,884,506,242,55,643,2330
135478,1148,1442,287,89,1148,4114
135480,269,99,13,0,42,423
135484,574,138,144,10,476,1342
13549,0,0,0,0,0,0
135499,33,1,0,1,16,51
135572,112,1,0,0,2,115
135582,271,8,139,6,96,520
135589,286,81,139,4,142,652
135594,538,31,246,28,219,1062
135600,2797,239,185,34,482,3737
135607,3589,64,614,27,1503,5797
135636,527,102,121,5,151,906
135645,231,1,0,4,24,260
135652,145,33,0,0,0,178
135685,299,122,131,8,11,571
135686,193,56,135,9,36,429
135688,286,214,141,18,187,846
135690,1,66,143,4,0,214
135691,282,138,118,13,111,662
135697,27,30,0,0,0,57
135702,0,79,55,6,0,140
135703,91,11,11,3,9,125
135705,294,50,107,10,8,469
135715,288,157,143,23,202,813
135718,2004,964,1133,125,786,5012
13572,0,0,0,4,0,4
135721,242,29,138,13,191,613
135722,519,308,257,10,37,1131
135724,1078,497,566,54,256,2451
135726,185,25,130,4,3,347
135733,286,294,141,21,191,933
135735,859,325,336,24,208,1752
135739,200,66,143,1,70,480
135743,286,279,143,27,196,931
135744,543,339,144,33,147,1206
135755,286,103,144,14,100,647
135758,0,253,158,25,0,436
13576,0,0,0,0,0,0
135760,228,0,143,0,0,371
135762,492,160,141,21,74,888
135768,286,116,143,13,57,615
135775,366,113,122,4,28,633
135776,557,354,154,61,229,1355
135780,1,274,205,21,0,501
135781,37,13,94,3,8,155
135782,310,168,231,17,156,882
135783,0,4,85,0,0,89
135792,45,0,110,1,4,160
135795,1010,320,428,52,240,2050
135801,162,60,83,11,0,316
135802,239,60,144,3,40,486
135804,164,195,27,12,0,398
135808,320,124,62,8,34,548
135809,287,12,143,4,25,471
135810,178,26,0,4,12,220
135815,33,41,76,9,0,159
135817,135,50,278,3,31,497
135818,286,264,143,26,215,934
135824,0,0,0,0,0,0
135826,546,199,395,24,110,1274
135834,571,353,278,30,152,1384
135835,0,11,0,0,0,11
135836,273,107,143,7,31,561
135837,288,244,143,31,151,857
135839,278,69,21,7,33,408
135844,179,20,143,1,26,369
135845,287,374,144,22,159,986
135846,120,177,143,18,135,593
13585,1581,230,0,30,68,1909
135851,299,93,242,5,46,685
135854,421,87,111,9,26,654
135855,244,31,93,2,6,376
135859,0,116,15,13,0,144
135861,275,100,143,16,191,725
135876,146,279,159,20,0,604
135887,23095,1114,404,356,11637,36606
135905,4384,178,24,30,288,4904
1360,0,0,0,0,0,0
136000,139,0,0,0,1,140
13604,0,0,0,0,0,0
136040,0,0,0,0,0,0
136052,758,342,17,16,301,1434
136055,59,9,58,1,8,135
136065,288,316,144,24,243,1015
136067,67,0,0,0,1,68
136075,88,15,80,2,13,198
136078,287,75,144,6,175,687
136088,539,102,130,2,239,1012
136093,691,98,223,7,164,1183
136100,391,90,0,10,174,665
136101,258,55,0,6,36,355
136107,443,204,48,3,530,1228
136111,18,4,0,0,0,22
136119,2418,732,307,45,994,4496
136121,97,13,91,1,21,223
136128,287,24,143,1,90,545
136131,353,33,82,0,246,714
13614,0,0,0,0,0,0
136167,460,0,0,0,27,487
136175,9,0,0,0,19,28
136190,667,50,4,0,19,740
136198,307,80,4,1,76,468
136199,932,60,50,0,12,1054
136200,7981,1305,254,8,569,10117
136230,0,49,152,10,0,211
136237,23,0,0,0,1,24
136244,203,16,24,1,56,300
136258,11,0,0,0,1,12
136279,0,30,76,4,0,110
136284,1411,1043,588,95,679,3816
136285,24,1,0,0,2,27
136288,286,203,141,23,213,866
136295,287,192,143,22,152,796
136297,286,180,141,23,137,767
136300,283,203,141,25,163,815
136301,264,35,0,1,24,324
136302,978,513,429,45,168,2133
136305,438,196,143,19,154,950
136306,185,201,47,7,6,446
136308,9,30,58,0,0,97
136320,114,44,143,6,24,331
136327,203,83,141,7,24,458
136328,113,21,131,4,26,295
136330,270,95,116,7,60,548
136333,281,106,142,23,102,654
136334,4402,2637,1498,319,1953,10809
136336,12,203,152,17,84,468
136337,0,69,0,4,0,73
136342,703,264,9,27,108,1111
136343,292,74,143,8,24,541
136344,0,147,78,22,0,247
136345,286,167,141,13,90,697
136349,0,24,74,4,0,102
136355,286,257,143,35,182,903
136356,84,21,22,2,6,135
136358,287,207,141,26,173,834
136361,283,151,140,24,91,689
136364,45,23,107,4,11,190
136365,254,82,13,6,31,386
136368,0,207,76,10,0,293
136371,0,229,136,20,0,385
136372,0,0,42,0,0,42
136373,764,330,282,33,156,1565
136374,179,67,171,11,67,495
136376,286,174,143,13,136,752
136377,660,165,26,16,48,915
136379,55,0,0,9,2,66
13638,1,0,152,0,0,153
136384,0,0,0,10,91,101
136393,0,57,67,5,0,129
136404,52,1,0,0,33,86
13641,0,0,0,0,0,0
13649,508,4,52,10,5,579
136493,196,1,0,3,24,224
13651,0,0,0,0,0,0
136513,300,2,0,1,0,303
136515,2030,91,544,51,1076,3792
136518,226,16,4,4,0,250
136538,260,90,0,15,6,371
13654,0,0,0,0,0,0
136547,358,2,2,1,0,363
136557,1006,990,6,41,363,2406
13659,0,0,0,0,0,0
136620,16,0,0,1,1,18
136634,21,32,0,4,28,85
136636,450,209,144,20,46,869
136639,788,596,494,53,375,2306
136646,187,117,0,15,45,364
136649,1,27,45,0,1,74
136651,260,124,141,15,88,628
136653,85,22,139,1,12,259
136654,286,201,144,26,165,822
136665,23,4,67,1,2,97
136671,286,203,141,26,177,833
136676,252,92,143,10,37,534
136684,0,69,78,9,0,156
136688,0,11,76,3,0,90
136700,0,77,139,10,0,226
136708,0,195,78,24,0,297
136710,69,52,0,13,11,145
136714,620,320,127,27,89,1183
136716,0,121,78,13,0,212
136717,253,41,141,4,33,472
136719,286,164,4,29,119,602
13672,0,1,422,13,0,436
136721,503,242,143,11,103,1002
136749,0,62,58,4,0,124
13676,1,0,0,0,0,1
136782,11,0,4,0,6,21
136800,904,3,117,8,113,1145
136803,572,1,76,1,113,763
136805,568,31,0,4,305,908
136823,346,9,51,1,177,584
136841,288,20,100,1,41,450
136856,271,31,2,0,25,329
136861,571,155,116,7,191,1040
136865,260,160,0,1,242,663
136873,554,277,144,4,498,1477
136874,90,33,72,1,30,226
136879,591,58,203,2,73,927
136880,259,4,15,2,14,294
136885,155,5,0,0,1,161
136897,706,3,4,17,147,877
136902,458,98,98,20,114,788
136907,7265,425,171,320,1781,9962
13692,1821,158,104,20,511,2614
136929,494,13,11,26,159,703
13693,0,0,0,0,0,0
136956,0,80,74,4,0,158
136958,1126,26,48,0,3,1203
136959,224,0,0,4,1,229
136972,571,446,128,25,522,1692
136982,556,11,48,0,32,647
136993,1448,3,0,22,64,1537
136994,1310,771,385,46,570,3082
137,16740,258,722,4,1856,19580
137000,527,224,226,21,129,1127
137004,144,20,352,2,9,527
137005,0,9,0,0,0,9
137074,462,23,8,6,20,519
137083,321,41,126,17,110,615
137084,1,164,131,12,0,308
137085,294,164,144,15,59,676
137093,524,241,286,19,74,1144
137097,251,217,111,17,94,690
137098,1004,407,713,56,339,2519
137100,199,43,112,4,2,360
137101,597,347,233,32,101,1310
137109,846,516,432,56,584,2434
137110,271,60,116,17,68,532
137118,88,31,139,1,7,266
137123,218,49,143,6,42,458
137125,285,107,133,8,40,573
137132,4,51,76,6,1,138
137135,655,282,109,39,129,1214
137142,274,102,125,24,95,620
137143,0,140,143,12,0,295
137144,283,164,141,13,78,679
137151,801,227,287,28,96,1439
137152,282,121,143,16,80,642
137154,284,99,143,7,93,626
137159,122,13,11,1,3,150
137165,569,379,141,23,72,1184
137166,2355,1105,909,136,818,5323
137167,0,48,83,6,0,137
137169,67,16,135,0,4,222
137172,249,60,141,9,26,485
137174,261,113,143,10,53,580
137181,413,151,105,20,46,735
137226,5730,374,646,111,1992,8853
137236,491,200,85,1,132,909
137248,288,104,0,16,131,539
137263,1000,17,0,9,60,1086
13728,0,0,0,0,0,0
137287,88,5,0,1,10,104
137302,16,2,0,0,0,18
137306,44,7,100,1,1,153
137308,31,55,0,0,9,95
137311,329,6,99,2,5,441
137316,306,20,0,0,83,409
137324,186,31,15,0,8,240
137329,575,337,137,9,488,1546
137331,882,235,308,31,334,1790
137342,196,1,0,0,5,202
137363,507,121,9,3,109,749
137378,240,43,73,0,36,392
137384,34,4,44,0,1,83
137406,1073,5,90,2,180,1350
137409,598,38,2,5,123,766
13742,0,0,0,0,0,0
137443,2822,10,45,18,117,3012
137487,356,0,4,0,21,381
137522,569,318,171,23,388,1469
137586,270,67,118,13,31,499
137594,147,103,75,3,33,361
13760,0,0,0,0,0,0
137608,214,48,110,7,6,385
137612,286,138,119,10,92,645
137619,286,305,143,28,176,938
137620,0,51,76,3,0,130
137624,0,182,82,12,0,276
137628,85,30,143,1,7,266
137633,286,166,143,10,175,780
137636,0,168,83,18,0,269
137642,286,46,143,1,91,567
13765,0,0,0,0,0,0
137654,0,11,35,1,0,47
137656,12,23,0,1,48,84
137657,279,145,134,22,99,679
137659,38,8,0,0,1,47
137666,90,8,13,0,1,112
137668,260,96,132,1,42,531
13767,0,0,0,0,0,0
137677,286,206,143,29,158,822
137678,594,313,286,28,117,1338
137679,527,103,143,16,44,833
13768,442,58,0,1,325,826
137681,179,49,143,4,42,417
137687,35,0,0,0,0,35
137689,5072,3,12,4,2,5093
137690,5,0,0,0,0,5
137692,2403,0,0,0,33,2436
137693,200,2,0,0,0,202
137694,598,34,2,0,0,634
137697,1006,19,27,1,24,1077
137702,414,6,0,0,1,421
13776,0,0,0,0,0,0
137785,275,1,0,5,16,297
1378,323,0,0,0,14,337
13781,0,0,0,0,0,0
137811,555,86,159,22,429,1251
137818,281,5,24,1,119,430
13783,32,0,0,0,0,32
137853,2,0,4,1,0,7
137854,0,0,0,0,0,0
137872,2931,6,534,48,2302,5821
137922,157,174,0,10,18,359
137956,112,15,0,0,5,132
13796,0,0,40,0,0,40
137969,351,7,21,6,25,410
137990,296,1,20,3,33,353
137996,217,2,26,7,77,329
138011,23,0,0,2,9,34
138025,396,9,154,20,60,639
13804,271,4,0,0,101,376
138050,256,66,11,16,40,389
138062,149,64,51,1,151,416
138064,576,356,136,4,410,1482
13807,0,0,0,0,0,0
138074,333,228,31,1,135,728
138079,288,34,15,5,60,402
138080,258,98,102,1,76,535
138087,288,20,134,3,124,569
138089,692,237,147,43,291,1410
13809,0,0,0,0,0,0
138096,571,315,124,12,412,1434
138100,864,520,144,28,669,2225
138109,406,161,113,2,202,884
138112,175,36,0,1,6,218
138119,460,31,0,0,83,574
138123,286,222,144,28,280,960
138130,576,400,144,24,645,1789
138131,58,0,2,0,0,60
138134,493,113,116,4,325,1051
138143,12,1,6,1,8,28
138144,15,0,31,0,0,46
138195,0,0,0,0,0,0
138225,290,181,208,20,129,828
138227,286,150,139,13,72,660
13823,0,0,0,0,0,0
138235,278,303,142,40,91,854
138239,172,10,105,2,2,291
138240,85,42,141,4,4,276
13825,0,0,0,0,0,0
138252,0,9,0,3,35,47
138258,286,175,141,17,167,786
138259,150,1,15,0,5,171
138262,272,87,143,10,14,526
138263,243,19,121,7,19,409
138264,0,119,0,10,34,163
138267,258,124,143,11,70,606
138269,138,25,143,7,33,346
138272,270,100,0,4,18,392
138276,288,251,144,27,201,911
138277,289,233,143,30,185,880
138278,248,63,0,11,64,386
138279,398,153,144,24,124,843
138280,283,140,0,20,113,556
138289,0,50,2,5,0,57
138290,560,326,281,59,274,1500
138294,0,5,0,0,0,5
138296,1733,754,529,121,449,3586
138297,277,79,141,11,41,549
138309,206,30,4,4,8,252
138311,1687,1024,712,65,802,4290
138316,166,23,4,9,9,211
138317,72,4,143,3,5,227
138329,286,85,118,16,84,589
138340,38,0,0,0,0,38
138364,287,150,141,24,156,758
138378,111,0,2,0,0,113
138379,527,1,30,5,115,678
138384,2012,83,25,136,1417,3673
138411,284,134,143,21,108,690
138456,80,1,40,1,5,127
138494,0,275,73,31,0,379
138496,11,0,0,0,0,11
138520,936,550,290,66,346,2188
13853,0,0,0,0,0,0
13855,0,0,0,0,0,0
13857,1750,49,72,18,401,2290
138671,285,178,141,17,244,865
13868,1158,6,103,1,222,1490
138689,667,1,15,0,80,763
138709,41,8,123,3,63,238
138711,286,77,132,10,130,635
138716,267,223,126,29,127,772
138726,196,59,139,4,34,432
138729,279,156,2,22,62,521
138731,153,69,143,8,50,423
138737,226,64,141,8,23,462
138738,395,110,146,1,79,731
138741,42,6,0,2,1,51
138746,0,131,141,4,0,276
138750,207,89,137,13,27,473
138752,5,56,64,4,2,131
138754,0,1308,715,97,0,2120
138755,0,3,78,4,0,85
138756,0,4,72,1,0,77
138758,348,146,89,10,87,680
13876,848,87,109,22,139,1205
138762,92,43,95,5,6,241
138776,130,36,96,3,48,313
138781,40,8,132,1,4,185
138782,0,120,101,6,0,227
138783,250,94,141,4,145,634
138787,139,133,18,12,20,322
138788,253,131,128,10,37,559
138789,508,126,287,18,162,1101
138790,572,420,287,58,354,1691
138796,514,284,141,20,156,1115
138797,1,336,80,37,0,454
138798,1199,439,495,52,238,2423
138810,264,18,138,2,12,434
138823,572,60,106,0,343,1081
138828,351,41,0,1,65,458
138829,175,5,47,0,6,233
138830,40,1,0,0,5,46
138833,277,53,123,5,60,518
138839,106,16,0,0,189,311
138841,251,1,0,0,13,265
138847,16,2,13,0,1,32
13886,0,0,0,0,0,0
138860,306,171,67,1,255,800
138866,167,39,0,1,38,245
138868,118,31,0,3,5,157
138871,286,230,144,25,274,959
138873,205,3,0,0,11,219
138881,286,117,144,14,184,745
138886,280,62,127,6,147,622
138890,171,1,0,0,87,259
138891,381,138,76,1,240,836
138892,19,0,0,0,19,38
138915,535,49,2,11,119,716
138961,525,0,0,1,49,575
138965,632,9,90,5,198,934
138997,721,0,20,22,116,879
138999,0,23,74,3,0,100
139007,1217,41,0,0,0,1258
139034,274,1,56,1,16,348
13904,0,0,164,8,0,172
139070,73,0,0,4,1,78
139080,8,0,0,0,0,8
139082,263,23,0,6,27,319
13911,1802,15,4,5,214,2040
139190,616,393,100,15,1,1125
139195,567,556,543,41,183,1890
139201,299,5,0,0,0,304
139213,181,1,74,0,27,283
13927,0,0,0,0,0,0
139285,378,46,136,10,33,603
139327,771,1,33,2,32,839
139340,535,4,104,1,90,734
139365,88,2,0,1,99,190
139377,12,0,0,0,1,13
139382,286,9,141,0,172,608
139389,254,106,2,0,81,443
139401,62,5,0,0,4,71
139405,0,0,0,0,0,0
139409,384,225,10,0,313,932
139415,282,129,17,0,147,575
139421,331,258,105,1,132,827
139424,13,1,0,1,4,19
139425,210,47,108,6,47,418
139428,288,172,134,22,235,851
13943,0,0,0,0,0,0
139442,223,69,35,4,28,359
139446,288,6,40,5,67,406
139447,12,2,0,0,1,15
139449,288,203,0,0,267,758
139451,288,77,121,7,151,644
139460,988,250,123,0,192,1553
139464,543,16,0,3,16,578
139484,0,106,20,9,0,135
139490,1,2,17,3,12,35
139498,270,144,143,15,75,647
139504,788,245,346,30,87,1496
139508,146,37,119,6,12,320
139509,202,117,141,5,48,513
139514,236,55,119,8,31,449
139521,264,113,4,13,14,408
139524,51,12,112,1,8,184
139526,260,112,143,10,52,577
139531,151,46,143,2,33,375
139533,127,29,121,1,8,286
139537,287,189,143,20,130,769
139541,158,56,129,9,29,381
139542,30,1,0,0,1,32
139550,34,1,0,3,1,39
139558,528,131,284,14,85,1042
139628,339,215,55,1,126,736
139752,296,6,63,8,223,596
13977,621,12,1996,53,0,2682
139811,1,0,22,0,0,23
139817,48,1,0,0,2,51
139844,301,18,24,1,19,363
139884,0,0,0,0,0,0
13994,0,0,0,0,0,0
139940,280,45,140,1,64,530
139946,486,13,24,0,149,672
139947,0,0,99,0,0,99
139949,125,1,78,0,55,259
139951,288,114,144,15,243,804
139952,286,20,60,4,230,600
139955,288,78,144,5,250,765
139956,0,1,0,0,0,1
139957,242,17,128,4,11,402
139958,222,56,100,1,102,481
139962,154,16,107,0,82,359
139963,276,36,126,1,211,650
139967,288,65,134,3,130,620
139971,288,55,4,14,205,566
139972,129,34,89,2,86,340
139977,286,123,144,11,228,792
139978,214,12,96,0,22,344
139981,288,193,144,3,222,850
139982,355,133,0,4,291,783
139989,792,85,429,5,308,1619
13999,273,0,292,10,0,575
14,435,0,0,1,1,437
140004,116,0,0,0,1,117
140014,105,81,0,0,94,280
140031,180,9,0,2,7,198
140052,0,0,0,0,0,0
140061,962,127,48,0,0,1137
14007,494,9,0,1,34,538
140096,456,12,2,32,54,556
140116,178,29,0,3,8,218
140120,279,172,144,20,131,746
140122,264,100,141,11,251,767
140129,231,95,125,7,29,487
140137,157,32,143,10,30,372
140139,272,86,141,11,75,585
140145,2,1,0,0,0,3
140158,286,183,144,21,117,751
140164,286,195,144,19,145,789
14017,0,0,0,0,0,0
140171,228,80,125,12,37,482
140188,185,25,125,4,14,353
140189,285,119,110,17,52,583
140197,286,232,141,23,151,833
140242,59,15,29,1,8,112
140243,499,19,64,16,232,830
1403,5966,563,435,6,3105,10075
140308,1179,129,16,5,7,1336
140310,54,85,15,0,6,160
140312,348,83,0,0,5,436
140313,517,14,19,0,2,552
140314,931,111,115,0,3,1160
140315,376,30,4,0,1,411
140316,295,78,0,0,3,376
140317,3591,869,163,9,247,4879
140384,288,188,144,17,260,897
140385,288,55,144,3,262,752
140389,294,23,80,0,17,414
140401,190,19,107,4,80,400
140405,62,23,49,1,20,155
14041,0,0,0,0,0,0
140429,415,97,24,0,125,661
140443,444,8,79,0,54,585
140446,249,16,0,0,8,273
140448,288,258,144,35,262,987
140452,288,124,144,20,207,783
140457,0,52,110,4,0,166
140460,17,9,0,0,2,28
140464,278,1,144,1,78,502
140469,288,201,144,35,250,918
140475,268,174,0,1,199,642
140479,1,0,0,0,1,2
14048,0,0,0,0,0,0
140481,345,107,86,0,198,736
140500,113,0,0,4,8,125
14051,9262,941,420,73,4674,15370
14061,70036,11823,4476,5702,29962,121999
140647,172,4,0,0,0,176
140681,288,187,143,20,120,758
14072,77,0,0,0,0,77
140726,1153,114,4,1,4,1276
140876,572,518,18,39,479,1626
14090,0,0,0,0,0,0
140927,497,2,98,0,35,632
140966,20,117,6,4,75,222
141014,0,23,74,1,0,98
141016,556,1,78,0,13,648
14102,1982,20,68,8,485,2563
14103,0,0,0,0,0,0
141039,5,0,0,0,1,6
141049,32,1,0,0,1,34
14106,0,0,0,0,0,0
141065,286,156,24,0,217,683
141067,243,16,94,4,44,401
141069,195,146,0,3,116,460
141071,340,156,6,2,218,722
141074,250,116,13,0,77,456
141077,288,53,119,2,38,500
141078,62,8,54,1,16,141
141082,276,39,0,9,111,435
141083,181,58,0,9,37,285
141092,288,135,144,12,188,767
141098,535,232,89,1,265,1122
1411,66,0,2,0,0,68
141105,265,113,40,1,152,571
141107,146,26,27,0,55,254
141127,278,207,4,1,243,733
141130,111,9,80,1,16,217
141134,288,358,144,13,213,1016
141139,27,0,0,0,4,31
141145,288,77,144,16,223,748
141152,568,23,96,13,287,987
14117,5295,2132,859,122,2180,10588
141243,30,4,0,1,1,36
141248,115,2,0,0,9,126
141249,268,139,108,4,83,602
141254,164,24,2,5,50,245
141262,121,25,129,2,8,285
141271,1,88,26,14,61,190
141281,83,16,132,2,18,251
141292,235,63,0,4,18,320
141300,271,147,144,14,106,682
141301,126,14,143,1,21,305
141303,286,273,113,26,126,824
14131,0,0,0,0,0,0
141314,0,152,76,8,0,236
141321,280,139,144,21,110,694
141322,288,108,143,5,175,719
141323,209,50,139,8,31,437
141324,250,110,143,13,107,623
14140,0,0,0,0,0,0
14143,0,0,0,0,0,0
141461,698,322,30,26,264,1340
141492,257,223,143,17,160,800
1415,0,0,0,0,0,0
141512,84,47,0,6,11,148
14155,0,0,0,0,0,0
141574,286,137,143,11,103,680
141596,558,278,123,1,259,1219
141598,282,73,29,18,59,461
141600,126,12,94,3,16,251
141601,96,117,2,0,41,256
141607,286,206,144,19,254,909
141616,574,114,99,16,425,1228
141631,67,6,0,0,9,82
141634,284,134,76,3,135,632
14164,0,0,0,0,0,0
14169,110,2,0,1,1,114
14174,0,0,0,0,0,0
14178,0,0,0,0,0,0
14188,716,15,2,2,152,887
14200,0,0,0,0,0,0
14209,6,0,0,0,0,6
1423,0,0,0,0,0,0
14230,1584,18,4,9,111,1726
14232,1197,192,253,20,63,1725
14234,43,38,23,7,0,111
14237,1,0,47,0,0,48
14241,0,0,0,0,0,0
14259,4944,2251,669,195,1334,9393
14263,0,0,0,0,0,0
14265,10137,729,1141,53,600,12660
14282,977,33,28,13,159,1210
14288,11,0,0,0,0,11
14291,11419,481,2767,444,7633,22744
14325,0,0,0,0,0,0
14333,0,0,0,0,0,0
14340,75,4,2,13,0,94
14348,0,0,0,0,0,0
14363,0,0,0,0,0,0
14366,0,9,0,0,0,9
14368,0,0,0,0,0,0
14369,0,0,0,0,0,0
14371,0,0,0,0,0,0
14374,0,0,349,0,0,349
14381,94,2,0,0,0,96
14382,0,0,0,0,0,0
1441,0,0,0,0,0,0
14430,85,0,215,1,0,301
14438,0,0,0,0,0,0
14453,0,0,0,0,0,0
14457,569,1,139,11,31,751
14463,1832,15,113,24,158,2142
14464,35,0,32,0,0,67
14477,0,0,81,0,0,81
1448,0,0,0,0,0,0
14488,0,0,0,0,0,0
14492,0,0,0,0,0,0
14511,0,0,0,0,0,0
14512,0,0,0,0,0,0
14529,0,0,0,0,0,0
14543,0,0,0,0,0,0
14559,0,0,0,0,0,0
14569,714,0,0,0,0,714
14574,0,0,0,0,0,0
14609,120,0,0,4,1,125
14615,279,3,1284,80,4,1650
14618,44908,11662,821,1957,21719,81067
14636,0,0,0,0,0,0
14640,0,0,0,0,0,0
14654,0,0,0,0,0,0
14671,0,0,61,1,0,62
14677,1044,72,117,9,647,1889
14696,156,0,0,0,11,167
14703,0,0,0,0,0,0
14735,0,0,130,0,0,130
14749,0,0,0,0,0,0
14750,0,0,22,1,0,23
14760,0,0,0,0,0,0
14773,0,0,0,0,0,0
14775,0,0,0,0,0,0
14793,0,0,0,0,0,0
14828,1,0,0,0,0,1
14840,7035,247,572,118,1454,9426
14860,0,0,0,0,0,0
14868,12463,711,560,286,4117,18137
14869,0,0,0,0,0,0
14901,419,1,0,0,42,462
14921,441,2,0,1,30,474
14928,0,0,93,0,0,93
14955,0,0,0,0,0,0
14971,782,1,17,4,100,904
14977,0,0,0,0,0,0
14978,0,0,10,2,0,12
15003,0,0,0,0,0,0
15011,0,0,0,0,0,0
15024,0,0,0,0,0,0
15036,0,0,0,0,0,0
15054,0,0,0,0,0,0
15065,0,3,559,18,0,580
15081,0,0,0,0,0,0
15100,0,0,0,0,0,0
15102,1245,30,6,3,255,1539
15108,0,0,0,0,0,0
15119,0,0,0,0,0,0
15121,0,0,0,0,0,0
15123,420,8,174,34,174,810
15129,0,0,0,0,0,0
15142,0,0,0,0,0,0
15146,1,0,0,0,0,1
15153,188,0,149,0,0,337
15164,0,0,0,0,0,0
15165,0,0,0,0,0,0
15169,21793,8931,2731,669,1303,35427
15171,0,0,0,0,0,0
15177,1061,6,8,4,63,1142
15191,720,65,141,29,399,1354
15196,208,0,0,0,1,209
15199,204,0,0,0,1,205
15216,0,0,0,0,0,0
15221,0,0,0,0,0,0
15247,1556,4,0,10,14,1584
15250,0,0,0,0,0,0
15256,291,5,0,0,3,299
15267,0,0,0,0,0,0
15290,1053,7,62,17,28,1167
15296,803,2,0,2,29,836
15305,3504,23,256,21,288,4092
15311,2203,827,284,26,594,3934
15313,0,0,175,0,0,175
15318,779,26,23,0,1,829
15320,164,0,405,1,0,570
15321,2343,116,142,20,312,2933
15322,0,0,0,0,0,0
15326,256,0,0,0,11,267
15335,0,0,0,0,0,0
15350,0,0,0,0,0,0
15366,0,0,188,0,0,188
15372,0,0,0,0,0,0
15378,0,0,8,0,0,8
15383,0,0,51,0,0,51
15397,1,0,29,0,0,30
15405,663,2,4,0,70,739
15419,2157,10,162,33,519,2881
15425,95,0,261,0,15,371
15433,2552,16,94,2,161,2825
15435,0,0,165,0,0,165
15440,3870,22,252,3,384,4531
15451,18,1,0,0,0,19
15466,55,1,17,0,0,73
15468,19,21,8,10,0,58
15471,937,12,149,0,97,1195
15480,0,0,115,0,0,115
15488,0,0,0,0,0,0
15502,12839,4288,1011,77,10087,28302
15516,0,0,386,0,0,386
15525,2,0,17,11,5,35
15542,0,0,80,0,0,80
15547,3,0,189,1,1527,1720
15557,4590,0,971,4,111,5676
15580,4,0,0,0,0,4
15582,443,4,28,10,0,485
15589,8580,1703,816,18,765,11882
156,0,0,0,0,0,0
15600,17,0,268,22,2874,3181
15605,1236,26,190,5,83,1540
15614,0,0,105,14,15,134
15617,0,0,20,11,132,163
15623,293,0,73,1,707,1074
15625,0,0,0,0,0,0
15659,2692,138,515,8,227,3580
15663,825,6,0,0,25,856
15673,56,17,55,0,0,128
15675,281,0,33,0,11,325
15699,0,0,0,0,0,0
15704,6,0,317,28,364,715
15735,19111,777,1048,37,1271,22244
15744,0,0,0,0,0,0
15751,1729,162,12,23,1209,3135
15763,1635,0,294,0,15,1944
15765,1103,90,298,3,120,1614
15774,2,0,141,0,7,150
15782,5429,6,924,6,430,6795
15796,0,0,184,0,1047,1231
158,0,0,2,0,0,2
15806,1134,52,18,0,604,1808
15830,1876,63,313,33,34,2319
15844,731,8,33,0,67,839
15886,0,4,0,0,0,4
15892,30,1,0,0,1,32
15899,28,2,26,0,2,58
159,0,0,0,0,0,0
15925,1507,8,69,1,37,1622
15935,8,0,271,0,24,303
15941,151,0,4,1,98,254
15943,0,0,65,0,0,65
15955,0,0,17,13,87,117
15958,0,0,300,15,877,1192
15962,265,1,1096,18,273,1653
15965,1061,116,101,3,16,1297
15994,478,2,19,5,55,559
160,0,0,0,0,0,0
16006,0,0,204,1,4,209
16019,0,0,680,10,113,803
16024,930,2,103,0,21,1056
16030,0,0,4,0,0,4
16082,2,0,0,0,0,2
16086,22243,427,1400,91,5219,29380
16095,1623,301,158,7,49,2138
16097,276,2,796,10,1004,2088
1611,0,0,0,0,0,0
16117,2040,14,238,6,669,2967
16143,0,33,9,0,0,42
16154,0,0,95,0,102,197
16175,1439,43,10,1,250,1743
16178,5,0,215,9,924,1153
16185,1076,65,121,3,359,1624
16191,435,24,74,0,20,553
16202,394,0,434,21,1710,2559
16205,378,63,50,1,1,493
16206,0,0,109,0,0,109
16211,0,0,8,0,0,8
16232,30976,957,2103,113,16930,51079
16234,584,90,46,1,338,1059
16245,0,0,289,0,0,289
16246,0,0,152,6,48,206
16247,522,103,0,2,364,991
16276,37011,8673,2462,875,13181,62202
16281,0,0,0,0,0,0
16283,0,0,11,0,0,11
16285,0,0,0,0,0,0
16302,18,5,4,0,0,27
16316,1384,1,158,0,49,1592
16345,0,214,28,11,0,253
16347,0,0,2,0,7,9
16353,0,0,0,0,0,0
16354,0,0,0,0,0,0
16367,0,0,0,0,0,0
16371,0,0,213,0,1,214
16391,0,0,0,0,0,0
16397,4050,79,373,142,158,4802
16399,0,0,0,0,0,0
1640,3687,9,10,14,472,4192
16413,139,0,0,0,0,139
1643,0,1,60,1,0,62
16430,0,0,0,0,0,0
16433,0,0,34,0,0,34
16438,976,4,8,1,164,1153
16462,310,0,0,0,52,362
16468,0,0,0,0,0,0
16478,34,0,0,0,6,40
16492,0,1,0,0,0,1
16495,0,0,0,0,0,0
16504,466,5,513,16,20,1020
16509,120543,35076,3763,3715,54953,218050
1651,0,0,0,0,0,0
16519,0,0,0,0,0,0
16524,571,5,0,1,33,610
16527,0,0,0,0,0,0
1653,2346,61,246,2,155,2810
16531,0,0,0,0,0,0
16532,2178,27,18,1,643,2867
16564,0,0,0,0,0,0
1657,0,0,0,0,0,0
16574,0,0,0,0,0,0
16582,0,0,10,0,0,10
1659,33110,643,1204,197,785,35939
16591,4492,1179,2244,525,4778,13218
16604,0,0,0,0,0,0
16608,0,0,0,0,0,0
16609,0,0,0,0,0,0
16612,0,0,0,0,0,0
16616,0,0,0,0,0,0
16617,539,4,0,6,8,557
16623,65,0,0,0,1,66
16628,0,0,0,0,0,0
16629,1093,827,255,69,871,3115
16654,0,0,0,0,0,0
16664,522,11,25,0,61,619
16685,1583,55,143,8,27,1816
16696,403,4,8,1,46,462
16698,0,0,0,0,0,0
167,0,0,0,0,0,0
16700,2,0,0,0,0,2
16701,5,8,2,0,0,15
16708,324,0,192,0,101,617
16713,2189,292,377,34,507,3399
16717,0,0,0,0,0,0
16732,255,54,0,0,13,322
16735,28273,825,716,453,4572,34839
16739,0,0,0,0,0,0
16750,0,0,0,0,0,0
16788,0,0,0,0,0,0
16803,0,0,0,0,0,0
16814,4155,1345,397,180,597,6674
16822,617,10,41,8,85,761
16823,0,0,0,0,0,0
16824,0,0,0,0,0,0
16832,0,0,0,0,0,0
16837,168,0,143,0,3,314
16842,0,0,0,0,0,0
16843,0,0,0,0,0,0
16851,0,0,0,0,0,0
16863,47,0,11,0,0,58
16895,1643,160,32,35,827,2697
16904,0,0,0,0,0,0
16922,0,0,0,0,0,0
16942,2265,17,193,12,267,2754
16954,0,0,0,0,0,0
16958,0,0,0,0,0,0
16960,0,0,0,0,0,0
16966,24,0,0,0,0,24
16988,0,0,0,0,0,0
17,0,0,0,0,0,0
17004,0,0,0,0,0,0
17018,412,19,0,0,86,517
17035,0,0,0,0,0,0
17046,0,0,0,0,0,0
17049,0,0,0,0,0,0
17054,1241,19,15,8,13,1296
17055,0,0,0,0,0,0
17064,0,0,0,0,0,0
17069,659,77,9,27,26,798
17072,406,26,193,38,198,861
17090,0,0,0,0,0,0
17093,0,0,0,0,0,0
17108,616,7,0,16,13,652
17113,0,0,20,8,0,28
17115,0,0,0,0,0,0
17135,0,0,0,0,0,0
17143,0,0,0,0,0,0
17147,180,134,72,1,71,458
17177,0,0,0,10,0,10
17184,30,0,0,1,0,31
17190,163,13,0,2,7,185
17202,0,0,0,0,0,0
17210,0,0,0,0,0,0
17211,0,0,0,0,0,0
17212,0,0,0,0,0,0
17216,1,0,0,0,9,10
17222,10717,1711,996,317,1069,14810
17223,8,0,0,0,0,8
17227,0,0,0,0,0,0
17253,0,0,0,0,0,0
17279,0,0,0,0,0,0
1729,0,0,0,0,0,0
17293,0,0,0,0,0,0
17306,1027,12,19,0,98,1156
17310,0,0,0,0,0,0
17356,0,0,75,1,0,76
1736,0,0,0,0,0,0
17378,0,0,84,1,0,85
17379,6203,338,0,97,1562,8200
17380,423,3,27,16,16,485
17385,1,1,40,12,63,117
174,35978,2508,8999,847,9575,57907
17402,0,0,0,0,0,0
17408,311,0,4,2,0,317
1741,0,0,15,0,1,16
1742,0,0,0,0,0,0
17421,21731,167,48,39,79,22064
17426,758,193,202,8,63,1224
17436,1,12,11,0,0,24
17439,526,626,6,21,11,1190
17444,8220,1,738,124,378,9461
17451,5004,1700,892,112,3473,11181
17454,534,73,184,20,217,1028
17465,5,3217,414,325,689,4650
17477,1189,996,324,3,432,2944
17483,1725,975,689,104,320,3813
17488,24903,12455,1029,1039,3815,43241
17501,1001,598,282,38,310,2229
17506,2233,24,4,31,917,3209
17511,19643,2718,2128,139,11354,35982
17514,0,0,0,0,0,0
17529,9832,19,71,25,872,10819
17530,0,0,0,0,0,0
17534,7891,686,51,12,412,9052
17538,211,26,4,1,116,358
17547,4730,918,449,125,2004,8226
17551,1842,494,11,4,537,2888
17552,1746,22336,562,1094,6,25744
17553,148,1,20,0,8,177
17554,33,1,2,0,0,36
17557,0,0,0,0,0,0
17564,0,72,26,0,0,98
17573,3609,0,0,0,5,3614
17575,421,0,0,0,9,430
17577,30,0,0,1,269,300
17583,0,0,0,0,0,0
17584,0,0,0,0,0,0
17586,15,0,0,0,16,31
1759,14820,1593,658,69,3411,20551
17593,1,0,0,0,0,1
17597,3528,2,0,1,1,3532
17598,235,0,0,0,0,235
17608,6,0,0,0,0,6
1761,0,0,0,0,0,0
17613,0,0,0,0,0,0
17621,25267,2651,95,35,321,28369
17622,2060,29,8,0,40,2137
17623,1811,41,10,0,0,1862
17625,2698,1025,1043,64,238,5068
17638,1179,55,14,0,1,1249
17639,48377,2210,8131,618,12057,71393
1764,1700,20,82,7,22,1831
17658,835,44,141,12,213,1245
17665,8093,4048,2238,464,3081,17924
1767,0,0,0,0,0,0
17670,2213,723,651,35,1131,4753
17671,530,20,2,0,276,828
17676,81011,4682,1140,646,16405,103884
17682,1,20,0,0,0,21
17698,138,1,0,0,0,139
17707,1,0,0,0,0,1
17709,6874,167,99,130,10,7280
17711,1625,12,10,7,0,1654
17713,1910,28,59,25,7,2029
17716,1867,88,67,17,24,2063
17726,1660,0,0,6,34,1700
17727,280,58,102,1,4,445
17733,3,0,0,1,0,4
17734,1118,517,271,6,638,2550
17747,398,291,344,45,76,1154
17753,0,0,0,0,0,0
17754,54,3175,388,222,16,3855
17762,4843,3042,850,107,792,9634
17766,2357,548,210,20,510,3645
17771,0,144,163,23,0,330
17781,5,0,0,0,0,5
17809,15545,295,166,302,319,16627
17813,1712,2413,475,71,736,5407
17816,17762,477,103,14,91,18447
17831,257,7,2,10,6,282
17839,841,2,0,0,785,1628
17841,212,0,2,0,0,214
17849,8822,1,285,3,39,9150
17853,7039,9,35,94,230,7407
17854,5720,4,15,4,33,5776
17857,7436,0,0,0,76,7512
17858,39373,402,1344,12,4777,45908
17862,113,0,0,0,1,114
17864,8302,0,160,2,35,8499
17870,777,0,0,0,0,777
17871,3177,0,0,0,7,3184
17877,235,0,0,0,1,236
17878,2,0,0,3,0,5
17885,1417,658,142,53,863,3133
17887,475,455,0,1,55,986
17895,4484,18,55,4,414,4975
17897,2893,182,93,0,0,3168
17924,10743,90,676,25,2345,13879
17931,0,1,0,1,0,2
17932,0,0,0,0,0,0
17936,1988,4,0,2,416,2410
17939,119,1,0,0,56,176
17940,905,21,11,6,169,1112
17941,753,0,97,1,116,967
17955,0,0,0,0,0,0
17956,0,0,0,0,0,0
17958,0,0,0,0,0,0
17960,525,3,26,0,11,565
17961,5562,420,84,15,576,6657
17962,925,3,0,0,0,928
17964,976,81,2,0,3,1062
17968,368,0,0,0,0,368
17970,2974,14,585,18,242,3833
17971,0,127,0,2,0,129
17974,36364,29139,613,2485,34659,103260
17976,2540,1068,6,61,1569,5244
1798,504,12,0,0,0,516
17995,5930,1985,402,40,2183,10540
17996,343,95,0,0,113,551
18,0,0,0,0,0,0
18001,286,47,0,0,18,351
18002,1310,554,644,37,267,2812
18004,46,308,0,0,0,354
18026,2,0,0,0,0,2
18028,182,0,0,0,1,183
18033,334,0,0,0,0,334
18042,11432,556,540,273,678,13479
18046,3064,25,14,48,0,3151
18047,187,5,8,1,42,243
18049,12975,307,452,317,22,14073
18059,909,2,0,0,38,949
18068,0,0,0,0,0,0
18075,1725,144,0,10,424,2303
18077,1180,41,32,1,72,1326
18081,4663,442,253,12,2758,8128
18085,1,0,0,0,29,30
18088,3,7,0,2,1,13
18092,5080,5,41,2,190,5318
18094,0,0,0,0,212,212
18101,519,1029,67,7,4,1626
18103,3008,260,213,20,899,4400
18106,6407,2165,314,194,2613,11693
18114,337,1,4,0,1,343
18121,0,2,0,23,0,25
18126,14599,1544,2226,302,6455,25126
18129,4,0,0,0,0,4
18135,4381,17,41,1,647,5087
18136,0,0,0,0,0,0
18144,11131,595,1431,300,7025,20482
18150,859,15,474,1,508,1857
18158,1,0,0,0,0,1
18176,9,0,0,0,0,9
1818,0,0,0,0,0,0
18182,8457,73,228,40,364,9162
18187,4975,54,833,16,918,6796
18188,180,0,0,0,2,182
1819,0,0,0,0,0,0
18190,1129,0,268,0,48,1445
18196,4119,1881,1236,178,950,8364
18206,0,23,0,0,0,23
18207,10566,3918,794,395,1198,16871
18209,3,1363,148,133,0,1647
18229,7561,4660,3657,454,3344,19676
18233,2266,44,873,17,888,4088
18239,108,0,0,0,0,108
18245,123,1,0,0,0,124
18260,6409,50,82,33,2134,8708
18266,0,0,0,0,0,0
18267,472,0,0,0,15,487
18268,0,2,0,1,0,3
18276,561,0,0,0,70,631
18278,19,2,0,26,297,344
1828,149,1,10,4,28,192
18281,2265,23,14,4,384,2690
18282,251,0,0,0,2,253
18283,2421,38,0,0,532,2991
18298,67,0,0,0,2,69
18302,856,0,16,0,110,982
18310,4466,0,2,1,13,4482
18313,17,0,66,6,191,280
18318,7,0,0,0,0,7
1832,0,0,0,0,0,0
18330,249,0,0,0,10,259
18334,46,0,0,0,0,46
1835,812,28,116,6,83,1045
1836,119,0,135,4,1127,1385
18371,1787,591,69,23,1101,3571
18390,6434,1013,440,170,3593,11650
18403,25120,29932,5094,4457,76404,141007
18419,8425,127,212,151,199,9114
18420,114,9,16,18,106,263
18422,1,0,0,0,0,1
18429,7057,55,33,130,58,7333
18435,0,0,0,0,0,0
18450,0,0,6,6,0,12
18460,0,0,0,0,0,0
18474,0,0,9,0,0,9
18481,0,0,0,0,0,0
18491,0,0,0,0,0,0
18494,0,0,0,0,0,0
18495,0,0,0,0,0,0
18516,898,6,39,14,323,1280
1853,3,0,73,8,18,102
18530,2019,77,79,41,488,2704
18566,985,7,4,0,27,1023
18596,0,0,0,0,0,0
18615,0,0,0,0,0,0
18616,210,0,607,8,0,825
18618,0,0,0,0,0,0
18624,3329,14,17,2,366,3728
18632,3421,17,24,12,334,3808
18663,522,0,0,0,4,526
18671,37,0,74,0,0,111
18683,0,0,0,0,0,0
18687,29,0,4,0,0,33
18712,0,0,0,0,0,0
18723,5,0,0,1,0,6
18734,0,0,0,0,0,0
18747,1640,1054,242,88,237,3261
18779,31,0,0,0,22,53
18780,0,0,0,0,0,0
18786,262,0,24,0,44,330
18789,85,1,2,25,9,122
18791,0,0,0,0,0,0
18793,671,0,109,0,311,1091
18815,0,0,0,0,0,0
18822,2694,1057,383,141,780,5055
18859,0,0,0,0,0,0
1886,651,47,50,4,34,786
18875,187,0,2,0,1,190
18881,60412,10967,5568,2470,34855,114272
18883,0,0,0,0,0,0
18886,0,0,0,0,0,0
18889,0,0,0,0,0,0
18892,0,0,0,0,0,0
18897,2128,74,59,0,273,2534
18913,519,14,10,1,51,595
18933,47,0,38,1,38,124
18943,1,0,0,0,0,1
18978,0,0,0,0,0,0
18988,1893,22,159,12,350,2436
19006,0,0,0,0,0,0
19008,0,0,214,0,0,214
19009,6379,134,618,13,1029,8173
1901,14836,219,1619,13,391,17078
19019,0,0,0,0,0,0
19021,0,0,0,0,0,0
19032,0,0,0,0,0,0
19037,9174,3051,1406,216,1589,15436
19045,3904,0,0,0,0,3904
19058,0,0,0,0,0,0
19084,0,0,0,0,0,0
19092,1890,148,293,12,439,2782
19108,33868,246,676,92,4977,39859
19112,258,24,155,2,20,459
19113,65,0,0,0,0,65
19116,437,14,125,1,218,795
19148,0,0,0,0,0,0
19151,2,0,0,0,0,2
19158,1,0,0,0,0,1
1916,9991,712,810,38,341,11892
19165,3688,402,457,46,1804,6397
19170,0,0,0,0,0,0
19171,916,4,2,10,23,955
19182,16000,53,143,99,4929,21224
19184,0,0,0,0,0,0
19201,0,0,0,0,0,0
19212,9,0,13,0,0,22
19215,0,0,0,0,0,0
19218,369,1,2,0,46,418
19256,0,0,0,0,0,0
19257,769,2,0,0,306,1077
1930,2,0,0,0,56,58
19310,0,0,0,0,0,0
19318,0,0,0,5,0,5
19323,2,0,47,0,0,49
19331,1,0,0,0,0,1
19332,0,0,0,0,0,0
19381,1,0,8,0,41,50
19397,2816,97,1117,25,1004,5059
19399,331,0,0,4,0,335
19413,0,0,0,0,0,0
19416,0,0,0,0,0,0
19422,1443,474,706,16,114,2753
19428,0,0,0,0,0,0
19437,659,27,0,3,263,952
19504,0,0,0,0,0,0
19515,4647,220,329,11,1922,7129
19518,417,103,159,6,183,868
19526,0,0,0,0,0,0
19530,0,0,0,0,0,0
19544,288,0,0,0,58,346
1955,26,5,57,0,0,88
19564,0,0,0,0,0,0
19600,0,0,4,0,0,4
19605,2080,60,13,16,340,2509
19616,0,0,0,0,0,0
19627,0,0,0,1,0,1
19628,0,0,0,0,0,0
19635,6,0,42,0,0,48
19653,0,0,49,0,0,49
19662,1957,7,4,3,118,2089
196638,0,1,0,0,0,1
196695,4,5,15,0,0,24
196714,1217,4,116,0,17,1354
196735,0,0,113,2,5,120
196737,677,137,84,17,313,1228
196739,0,15,48,0,0,63
196742,17,50,349,7,31,454
196749,435,1,26,0,57,519
196750,0,1,29,0,0,30
196755,345,2,12,1,28,388
196767,0,1,11,0,13,25
196782,0,0,0,0,0,0
196786,0,8,13,0,0,21
1968,0,0,0,0,0,0
196815,0,0,4,1,0,5
196822,0,0,6,0,9,15
196838,467,4,39,2,18,530
196843,0,0,0,0,0,0
196845,0,0,67,0,10,77
196846,113,0,0,1,3,117
196865,1641,40,73,2,166,1922
196874,570,5,33,0,20,628
19689,45,0,91,0,0,136
196938,0,1,6,1,0,8
196954,1409,24,52,5,290,1780
196968,1105,6,42,0,63,1216
196976,141,3,43,0,6,193
196978,0,0,15,0,2,17
196983,477,3,10,0,33,523
197013,0,0,101,0,1,102
197019,0,0,14,1,12,27
197023,0,70,53,0,0,123
197029,0,0,2,0,2,4
197046,0,0,0,0,0,0
197050,0,0,0,0,51,51
197063,682,13,0,1,52,748
197070,0,0,2,0,0,2
197075,2364,41,318,2,162,2887
197078,0,46,88,0,30,164
197126,120,1,0,0,5,126
197129,0,48,56,1,0,105
197156,0,0,2,0,0,2
197163,0,2,2,0,0,4
197197,0,0,122,0,5,127
197206,0,0,0,0,0,0
197212,752,39,51,6,249,1097
19723,44,0,108,0,1,153
197248,0,0,2,0,0,2
19726,0,0,0,0,0,0
197288,38911,2601,1600,189,3705,47006
197293,784,3,206,1,62,1056
197301,0,0,0,0,0,0
197307,66,0,15,0,0,81
197324,0,0,4,0,82,86
197393,0,0,34,0,0,34
197394,209,38,92,11,0,350
197398,0,0,9,0,0,9
197423,0,0,334,25,224,583
197451,0,0,13,0,1,14
19746,0,0,0,0,0,0
197470,108,0,13,0,65,186
197498,58,1,98,0,0,157
19751,0,0,0,0,0,0
19752,866,60,78,0,214,1218
197524,0,0,46,9,495,550
19754,0,0,0,0,0,0
197540,1058,5,4,13,282,1362
197550,0,0,0,0,0,0
197558,0,0,273,0,95,368
197565,0,0,40,0,5,45
197589,1702,20,117,14,167,2020
197595,2510,2,309,14,171,3006
197623,2521,7,77,18,241,2864
197637,3173,120,187,17,725,4222
197650,832,26,212,7,170,1247
197663,26,0,8,0,2,36
197664,1398,25,509,24,141,2097
197695,681,10,8,21,0,720
197698,0,0,0,0,0,0
197706,0,0,13,0,26,39
197784,962,15,18,0,84,1079
197798,0,0,30,0,5,35
197846,0,0,11,0,0,11
197853,680,68,14,1,215,978
197879,22,0,133,0,1,156
197897,0,0,109,0,263,372
197954,1600,26,197,0,55,1878
197957,428,16,12,3,118,577
19799,0,0,0,0,0,0
19800,372,57,165,16,285,895
198002,0,0,9,0,0,9
198089,0,0,8,0,0,8
198090,1624,32,102,11,255,2024
198102,907,8,192,17,42,1166
198110,19,9,4,0,0,32
198128,849,6,15,2,106,978
198137,0,87,96,12,0,195
19817,0,0,0,0,0,0
198172,0,0,0,0,149,149
198185,279,8,41,0,0,328
19819,0,0,0,0,0,0
198193,0,0,2,0,2,4
198203,0,0,137,0,0,137
198225,0,0,31,0,0,31
198248,6,0,6,0,0,12
198252,1,0,0,0,0,1
198259,0,0,0,0,15,15
198279,54,1,8,0,38,101
198292,817,17,67,19,256,1176
198295,0,2,0,0,0,2
19830,0,0,0,0,0,0
198371,0,0,2,7,41,50
198380,1547,16,12,19,334,1928
198397,0,0,0,0,0,0
198403,24,0,53,1,0,78
198420,0,0,17,0,0,17
198471,11479,336,516,19,1278,13628
198504,5,0,0,0,1,6
198518,0,0,0,0,0,0
198541,0,28,87,0,64,179
19855,0,0,0,0,0,0
198551,0,0,0,0,0,0
198570,3521,13,19,1,120,3674
198576,1,0,0,3,20,24
198605,8,0,0,0,1,9
198612,559,7,90,0,66,722
198632,242,2,141,4,7,396
198668,0,0,10,9,44,63
198682,0,0,0,0,0,0
19872,0,0,0,0,0,0
198721,577,1,155,0,36,769
198726,3099,44,57,10,283,3493
198760,0,0,47,0,8,55
198785,118,0,4,0,0,122
198814,0,0,6,0,0,6
198843,509,5,54,24,53,645
198875,0,0,0,0,2,2
198887,280,6,0,0,14,300
19889,1688,545,128,24,181,2566
198916,490,1,41,1,15,548
198949,70,0,33,0,0,103
198950,0,0,4,0,87,91
198966,433,1,0,0,46,480
198967,5261,71,101,1,250,5684
198977,0,0,0,0,0,0
199020,0,5,73,0,0,78
199026,546,13,121,4,25,709
199039,505,1,214,0,45,765
199042,303,3,4,0,4,314
199048,1,0,9,0,44,54
19905,28,8,0,0,2,38
199051,0,0,0,0,19,19
199081,144,1,13,10,11,179
199095,0,0,13,0,0,13
199096,0,1,0,0,0,1
199151,0,0,9,0,0,9
199173,0,0,14,2,241,257
199181,1744,154,47,7,106,2058
19919,1868,1,370,7,631,2877
19920,0,0,0,0,0,0
199214,0,0,0,0,0,0
199237,682,8,118,0,208,1016
199256,3356,324,289,17,646,4632
199276,285,4,23,19,93,424
199284,1378,17,162,0,225,1782
199298,0,0,0,0,0,0
199309,1182,52,256,17,477,1984
199312,13,0,0,0,8,21
199324,355,1,0,0,12,368
199335,0,0,24,0,0,24
199346,304,144,56,4,44,552
199348,545,3,21,3,9,581
19935,1096,2,0,0,502,1600
199362,122,11,65,3,26,227
199378,0,0,0,0,0,0
19939,271,1,0,0,65,337
199398,0,0,0,0,1,1
199493,0,0,2,0,142,144
199524,1272,121,10,64,456,1923
199536,270,4,19,1,68,362
19955,2,0,0,0,0,2
199551,0,0,0,0,0,0
19956,0,0,0,0,0,0
19957,0,0,0,0,0,0
199578,898,0,0,0,6,904
19963,0,0,35,0,0,35
199657,0,0,0,0,0,0
199665,0,0,0,1,0,1
199666,238,0,23,4,19,284
19969,0,0,0,0,0,0
199715,0,0,47,0,1,48
199736,0,0,0,0,15,15
1998,0,0,0,0,0,0
199837,743,23,64,11,115,956
1999,0,0,0,0,0,0
19990,1039,9,256,15,101,1420
199909,0,0,26,0,0,26
19994,0,0,0,0,0,0
199952,0,0,0,0,12,12
2,1873,40,0,28,283,2224
20,0,0,0,0,0,0
20001,9681,10,7418,1038,4452,22599
200023,0,0,0,0,0,0
200024,0,0,0,0,1,1
200026,40,0,4,0,43,87
200043,2301,50,234,4,263,2852
200046,457,49,52,24,351,933
200059,0,0,0,0,0,0
20009,236,0,0,0,0,236
200100,407,0,73,0,28,508
200114,0,0,98,0,0,98
200134,1409,88,320,62,348,2227
20014,0,0,0,0,0,0
200148,185,17,26,3,29,260
20015,337,71,2,1,3,414
20018,0,0,0,1,0,1
200185,80,0,4,1,1,86
200278,414,2,0,3,27,446
20030,0,0,0,0,0,0
200311,295,2,0,1,7,305
200345,607,6,26,1,188,828
200350,0,2,0,0,0,2
200355,0,0,0,1,0,1
200409,164,5,134,0,31,334
20042,0,0,0,0,0,0
200509,0,0,0,1,0,1
200519,604,0,0,1,10,615
200547,898,47,11,5,351,1312
200553,483,1,171,19,80,754
200565,317,58,4,2,116,497
20057,4737,419,1144,91,3485,9876
20058,0,0,0,0,0,0
200604,492,1,9,0,11,513
20062,0,0,0,0,0,0
200665,1602,5,54,1,54,1716
200689,516,15,122,7,189,849
200701,666,13,23,3,143,848
200735,649,17,154,5,186,1011
200752,994,128,141,3,391,1657
20077,0,0,0,0,0,0
200794,514,3,11,13,43,584
200799,497,5,29,0,45,576
200818,247,5,26,1,12,291
200845,0,0,0,0,0,0
200848,0,0,0,0,0,0
20085,0,0,0,0,0,0
200873,674,6,87,8,60,835
200901,125,2,2,2,6,137
200924,1010,0,260,2,94,1366
200939,8,0,0,0,0,8
200984,910,40,63,11,336,1360
201000,2618,134,39,30,1042,3863
20101,0,0,0,0,0,0
201011,429,5,233,1,52,720
20105,31,0,0,0,0,31
201058,585,11,8,0,37,641
201091,0,2,74,0,0,76
201102,473,10,6,2,36,527
201106,107,0,0,22,24,153
20115,142165,4263,8598,880,51101,207007
2012,4,0,0,0,0,4
201205,0,0,2,0,0,2
201249,120,0,0,0,30,150
201250,0,19,96,0,0,115
20126,0,0,0,0,0,0
201290,0,0,55,0,0,55
201296,0,0,82,0,0,82
201321,858,2,92,6,95,1053
201337,0,0,9,0,23,32
20135,0,0,0,0,0,0
201352,123,1,28,3,18,173
201367,62,0,0,0,2,64
20141,0,0,0,0,0,0
201411,0,0,0,0,22,22
201435,0,0,0,0,0,0
201474,1132,14,15,13,205,1379
201476,0,0,92,0,25,117
201502,0,0,0,0,0,0
201518,519,11,126,2,32,690
201525,0,0,0,0,0,0
201533,0,0,0,0,0,0
20154,0,0,0,0,0,0
201548,0,0,6,0,0,6
201577,543,46,28,0,24,641
201596,735,18,0,1,265,1019
201602,1290,6,118,5,108,1527
201603,0,0,0,0,23,23
201607,86,2,0,0,7,95
20161,3448,28,59,22,263,3820
201616,46,0,0,1,9,56
20162,0,0,0,0,0,0
201654,0,0,6,1,0,7
20167,0,0,6,0,0,6
201701,270,0,0,0,77,347
201704,0,0,0,0,0,0
201722,84,0,0,0,5,89
201729,325,10,13,0,129,477
201735,31,0,0,0,40,71
201770,77,0,0,10,20,107
201776,0,156,98,1,0,255
201800,0,0,0,0,0,0
201825,0,22,20,1,1,44
201826,4,2,0,0,0,6
201838,0,0,0,0,0,0
201847,441,4,32,8,47,532
201877,690,5,238,1,82,1016
201931,0,0,0,0,0,0
201952,0,5,4,0,0,9
201997,0,0,0,0,11,11
202015,54,0,0,17,2,73
20205,0,0,0,0,0,0
202053,882,354,8,40,529,1813
20207,4409,2157,1892,207,1078,9743
202074,1985,45,21,23,650,2724
202085,226,0,51,0,10,287
202120,0,0,13,0,0,13
20214,0,0,0,0,0,0
202146,5,0,0,1,5,11
202189,0,0,0,0,0,0
202193,278,1,0,0,25,304
202204,823,0,120,2,144,1089
202208,187,0,9,0,5,201
202209,15,0,2,1,52,70
20222,0,0,0,0,0,0
202220,0,0,0,0,0,0
202237,0,0,13,0,0,13
20224,720,77,199,10,325,1331
202242,58,2,0,1,0,61
20228,1053,71,2,6,22,1154
202296,1438,2,137,7,39,1623
202323,255,1,10,1,74,341
202334,0,0,0,0,54,54
202339,356,1,13,1,17,388
202347,310,2,8,1,62,383
20238,2,0,0,0,0,2
202382,462,2,13,1,63,541
202422,961,149,10,64,703,1887
202425,755,16,24,10,59,864
202433,1,1,0,0,178,180
202448,612,1,2,5,63,683
202454,1,0,2,7,0,10
202463,0,0,0,0,0,0
202491,0,0,0,0,0,0
2025,0,0,0,0,0,0
20252,19,0,0,0,0,19
20255,1489,316,392,12,74,2283
202551,0,0,63,0,0,63
202556,0,0,0,0,0,0
20257,0,0,0,0,0,0
202596,0,0,0,0,0,0
202618,0,0,2,0,5,7
202632,0,0,116,0,0,116
202635,76,0,0,0,3,79
202709,1113,5,55,7,18,1198
20271,194,10,0,0,58,262
202719,0,0,4,0,0,4
202725,215,0,4,4,12,235
20273,0,0,0,0,0,0
202761,560,16,29,1,15,621
202774,0,0,0,0,0,0
20278,569,5,8,2,88,672
202803,320,1,0,0,12,333
202817,4,0,0,0,0,4
202819,0,0,33,0,0,33
20283,0,0,0,0,0,0
202833,0,0,0,3,12,15
202870,1717,22,303,26,634,2702
202876,0,0,0,0,18,18
202883,11,0,0,0,5,16
202895,0,0,0,1,18,19
202909,496,2,11,0,18,527
202913,0,0,0,0,0,0
202921,0,0,33,7,0,40
202979,0,0,15,7,0,22
20298,0,0,0,0,0,0
202999,0,1,24,0,0,25
203,30,27,0,1,0,58
20300,0,0,0,0,0,0
203018,0,1,141,0,5,147
203020,65,11,0,8,39,123
20303,0,0,0,0,0,0
20305,48,14,0,0,8,70
203052,525,1,135,1,8,670
203068,0,0,0,0,0,0
203089,290,2,0,0,18,310
203103,0,0,2,0,0,2
203180,275,12,27,1,125,440
203223,1498,15,227,3,207,1950
203224,623,9,4,1,35,672
203228,394,3,0,0,43,440
203254,113,0,0,0,12,125
20326,122,0,8,1,1,132
20328,246,1,0,0,2,249
20329,0,0,0,0,0,0
203367,252,2,87,0,39,380
203424,1904,17,15,4,834,2774
203455,0,0,0,0,87,87
203462,489,10,138,1,14,652
203469,309,24,118,0,25,476
20347,0,0,0,0,0,0
203485,259,2,11,3,22,297
203489,1935,52,43,9,193,2232
203513,0,6,96,0,0,102
20352,31,0,0,0,0,31
203536,749,5,8,0,10,772
203540,183,27,383,1,47,641
20355,0,0,0,0,0,0
203550,0,0,0,0,0,0
20356,0,0,0,0,0,0
203591,2898,55,108,21,710,3792
203600,0,0,18,0,0,18
203641,0,0,0,0,0,0
20365,36,0,0,1,0,37
203672,61,0,29,0,1,91
203704,0,0,0,0,8,8
20371,0,0,116,3,0,119
203712,0,0,0,0,0,0
203713,133,3,28,0,109,273
203726,740,47,277,11,131,1206
203744,420,2,110,1,7,540
20376,0,0,0,0,0,0
203761,785,0,12,3,198,998
203791,0,9,0,0,0,9
203848,437,8,34,2,76,557
203865,555,1,15,3,199,773
203877,0,0,192,3,702,897
20392,0,0,0,0,0,0
203924,804,6,0,13,16,839
203929,288,0,2,0,31,321
20394,1723,115,41,3,428,2310
203953,1180,323,309,40,802,2654
203964,308,0,0,0,0,308
203991,0,0,0,0,0,0
204008,256,0,44,0,14,314
204026,0,0,0,0,0,0
204060,43,0,0,0,2,45
204073,804,6,0,1,188,999
204107,344,0,0,0,19,363
204108,50,6,2,1,0,59
20412,0,0,0,0,0,0
204121,181,3,174,2,63,423
20413,0,0,0,0,0,0
204141,0,0,31,0,0,31
204144,0,0,6,0,0,6
204151,44,0,0,0,1,45
204154,0,0,0,0,0,0
204158,272,121,2,0,38,433
204161,0,0,0,0,0,0
204165,0,0,4,0,0,4
204166,0,0,0,0,8,8
204180,143,88,20,0,10,261
204196,0,0,0,0,0,0
20426,0,0,0,0,0,0
204274,3834,393,763,6,1368,6364
204279,1027,22,24,0,123,1196
204285,273,6,8,0,89,376
20432,0,0,0,0,0,0
204353,254,2,0,0,96,352
20436,0,0,0,0,0,0
204366,41,1,0,0,0,42
204379,204,1,0,0,18,223
204383,0,0,11,0,0,11
204386,254,2,0,0,34,290
204389,17,0,0,0,4,21
204390,1101,99,162,25,414,1801
204402,188,0,0,0,3,191
204403,271,0,0,0,4,275
204410,5,1,33,0,0,39
20442,0,0,0,0,0,0
204444,0,0,2,0,0,2
204445,42,0,0,0,1,43
204458,284,70,2,1,202,559
20448,0,0,0,0,0,0
204490,0,0,0,0,0,0
204504,95,1,4,0,2,102
20452,0,0,0,0,0,0
20454,635,0,0,15,0,650
204570,0,0,9,0,0,9
204595,597,1,4,0,49,651
204601,0,0,35,0,0,35
204618,0,0,14,0,0,14
204622,901,26,67,6,320,1320
20473,19327,4020,1716,1802,11474,38339
204735,0,2,20,0,0,22
20474,175,9,78,4,89,355
20477,6,0,0,0,0,6
20478,0,0,0,0,0,0
204793,214,0,61,0,11,286
204809,1219,33,4,10,109,1375
204810,69,0,0,0,1,70
20485,108,176,320,1,7,612
204861,0,0,2,0,0,2
204873,0,0,0,0,0,0
204923,378,1,19,0,8,406
204943,0,0,0,0,0,0
204947,877,7,102,0,145,1131
204957,327,30,4,5,50,416
204989,0,0,0,0,0,0
205,0,0,0,0,0,0
205002,0,0,11,0,0,11
205005,879,37,12,1,219,1148
205016,37,229,0,4,36,306
205039,1170,143,12,8,512,1845
205042,669,0,43,0,53,765
205044,0,0,0,0,13,13
205051,718,10,126,1,142,997
205085,0,0,76,0,0,76
205099,571,16,4,0,86,677
205100,41,0,0,0,0,41
205110,197,6,26,22,90,341
205168,119,0,4,1,0,124
205199,1913,5,103,10,127,2158
205276,138,1,29,0,18,186
205284,45,0,9,13,8,75
205330,377,19,0,0,47,443
205343,0,0,0,0,15,15
205374,170,1,0,0,8,179
205385,616,12,11,22,194,855
205428,0,0,0,1,0,1
205439,0,167,72,7,0,246
205498,0,0,0,0,0,0
2055,0,0,0,0,0,0
205512,8,0,0,1,0,9
205515,0,0,2,0,0,2
205544,0,0,2,0,0,2
205553,0,0,15,0,0,15
205572,0,0,9,1,52,62
205582,0,0,0,0,0,0
20559,0,0,319,0,0,319
205619,0,0,0,0,1,1
205636,157,2,49,10,61,279
205645,30,0,0,0,12,42
205657,0,1,18,1,0,20
20581,0,0,0,0,0,0
205827,1,0,0,0,0,1
205832,0,0,0,0,185,185
205891,23,0,11,0,0,34
205968,0,0,11,0,2,13
206004,203,5,4,0,12,224
206022,540,21,9,0,44,614
206045,0,0,0,0,141,141
206067,6,0,0,16,0,22
206092,319,41,99,4,35,498
206175,376,5,0,1,20,402
206182,165,19,2,1,2,189
206194,0,0,0,0,0,0
206198,0,0,2,0,0,2
206238,0,0,0,0,0,0
20626,1962,6,131,7,505,2611
206262,0,0,57,7,247,311
206264,8,0,0,0,0,8
206270,0,0,6,0,0,6
206283,27,0,0,0,3,30
206296,0,0,0,0,0,0
206299,380,5,62,0,39,486
20632,1,28,55,0,0,84
20633,935,2,8,0,17,962
20634,0,0,15,0,149,164
206346,0,0,2,0,16,18
206355,326,8,12,0,81,427
206382,956,33,276,14,204,1483
20640,1104,2,19,1,28,1154
206429,0,0,2,0,0,2
206460,861,6,392,1,122,1382
206487,0,0,9,0,18,27
206498,515,1,56,0,258,830
206509,203,0,11,0,73,287
206539,1285,18,456,6,207,1972
206557,2750,620,415,37,1449,5271
20657,0,0,13,0,195,208
206588,295,1,0,0,36,332
206602,224,0,0,0,0,224
206610,0,0,0,0,0,0
206617,1273,13,223,27,96,1632
206655,585,28,133,9,82,837
206663,304,32,49,1,106,492
206701,831,33,90,0,190,1144
206723,829,39,153,4,128,1153
206732,511,27,18,0,337,893
206737,440,11,44,3,180,678
206738,60,0,42,0,1,103
206746,209,18,4,0,67,298
20676,15074,632,1539,3,737,17985
206761,1372,62,166,7,397,2004
20677,1864,10,41,1,121,2037
206772,0,0,0,0,16,16
206774,946,63,168,20,452,1649
206801,78,1,6,4,2,91
206804,12,1,0,1,0,14
206825,1279,1,10,1,16,1307
20686,962,32,62,0,63,1119
206881,98,1,2,0,12,113
206889,59,0,4,0,0,63
206892,0,0,0,0,0,0
206952,118,0,2,0,1,121
206961,202,2,2,0,3,209
206988,772,11,38,0,186,1007
206992,316,4,4,0,72,396
207028,399,11,199,1,122,732
207029,702,5,115,3,86,911
207044,6881,754,254,86,4458,12433
207054,1275,30,220,3,368,1896
20712,0,0,201,0,0,201
207136,4,0,0,4,9,17
207144,455,0,236,39,383,1113
207146,84,2,0,0,0,86
207176,0,0,0,0,0,0
207187,0,0,10,0,5,15
207198,0,0,0,4,0,4
207227,93,30,51,1,18,193
20723,12,1,251,2,6,272
207242,0,0,0,0,31,31
207253,598,0,136,1,16,751
207294,0,0,0,0,23,23
207348,59,1,0,22,11,93
207375,0,0,111,0,0,111
20746,537,2,654,1,5,1199
207464,2639,108,554,43,535,3879
207492,0,0,0,1,36,37
207569,81,0,0,0,0,81
207594,932,6,88,2,163,1191
207715,106,0,17,0,77,200
207725,330,5,4,1,54,394
20773,638,1,261,0,103,1003
207746,215,0,0,0,5,220
207761,504,1,22,4,49,580
207790,0,0,0,0,0,0
207876,61,1,0,0,32,94
207903,0,0,0,0,0,0
207923,0,0,0,0,5,5
207937,332,2,4,1,15,354
208017,284,5,0,0,22,311
208018,293,8,22,0,57,380
20804,0,0,49,0,13,62
208056,0,31,13,0,0,44
20807,113,1,6,0,0,120
20810,3098,24,248,5,512,3887
20811,8142,445,1286,8,1261,11142
208323,49,0,0,0,0,49
20836,1603,8,6,6,99,1722
208376,104,0,50,0,21,175
20842,0,2,0,0,0,2
20845,0,0,31,0,7,38
20847,0,0,39,0,0,39
208516,199,0,294,19,27,539
208574,90,0,0,1,8,99
208578,399,7,42,0,91,539
208598,368,14,2,0,27,411
20860,23,0,15,5,0,43
208701,0,1,11,0,0,12
208734,0,0,0,0,0,0
208764,30,1,0,0,1,32
20880,0,0,391,0,0,391
208803,0,1,0,0,0,1
208808,1384,24,171,9,138,1726
20884,0,0,0,0,0,0
208847,0,0,0,0,0,0
208851,386,5,46,7,37,481
208857,0,0,0,0,34,34
20886,2291,3,118,0,73,2485
208877,0,0,2,0,1,3
208920,158,3,4,0,0,165
208951,0,0,0,0,0,0
208954,0,4,0,0,0,4
208988,0,0,2,0,0,2
209,101634,2870,3750,434,15494,124182
20910,8320,146,1915,11,2804,13196
20911,0,0,106,0,358,464
20912,853,31,162,1,37,1084
209130,0,0,0,0,142,142
209181,0,0,0,0,0,0
209206,187,0,0,0,0,187
209222,209,0,4,0,17,230
209240,238,7,49,1,270,565
209277,212,7,18,11,133,381
209301,384,7,0,0,67,458
209302,0,0,0,0,23,23
209400,865,0,0,0,60,925
209424,270,13,0,8,132,423
209425,0,0,121,0,34,155
209429,0,0,0,1,0,1
209491,416,32,31,7,322,808
209492,0,0,0,0,0,0
20952,0,0,38,0,0,38
209528,0,0,0,0,0,0
209529,341,1,0,2,46,390
209564,0,0,80,0,120,200
209572,296,5,152,0,52,505
20959,1206,7,111,8,1,1333
209591,175,4,35,0,18,232
20960,0,0,0,0,0,0
209624,269,1,0,0,8,278
209688,0,0,9,0,0,9
209781,71,1,0,0,0,72
209810,0,0,0,0,0,0
209839,246,5,4,9,98,362
20985,0,53,0,0,0,53
209855,0,0,6,0,0,6
209897,450,2,10,20,82,564
209942,0,0,0,1,24,25
209970,410,0,154,1,25,590
209987,386,1,0,1,63,451
209992,342,5,53,2,44,446
210,4,0,0,0,0,4
210051,172,0,0,0,7,179
210070,100,0,0,0,5,105
210109,0,0,11,0,0,11
210125,70,0,0,0,280,350
210129,750,30,191,0,111,1082
21013,955,3,20,0,2,980
210150,1792,59,241,11,128,2231
21017,0,36,4,0,0,40
210172,208,2,155,11,12,388
210178,0,0,19,0,19,38
21019,0,0,4,0,0,4
21021,0,0,113,0,0,113
210218,1392,3,184,1,95,1675
210238,629,31,117,22,149,948
210278,4342,23,233,0,587,5185
210280,301,1,8,1,75,386
210298,275,0,8,1,8,292
210306,0,0,0,0,0,0
210329,52,0,0,0,0,52
21034,1790,48,537,4,469,2848
21040,0,0,30,1,123,154
21056,9046,920,1223,52,502,11743
21058,120,23,6,0,3,152
21062,19,0,6,0,2,27
21069,0,0,2,0,0,2
2107,3354,30,684,1,328,4397
2108,5157,231,959,3,264,6614
2110,9613,1457,431,14,3670,15185
21100,0,0,0,0,0,0
21107,4723,18,859,6,428,6034
2116,32465,1699,3168,70,9123,46525
21183,80,0,317,0,1109,1506
2119,42084,1634,4950,192,17912,66772
21191,243,1,0,0,0,244
21193,0,0,0,0,0,0
21195,5701,184,356,3,442,6686
21196,179,0,0,1,15,195
212046,7411,30,1027,39,1418,9925
21211,1559,50,492,9,604,2714
21221,0,0,0,0,0,0
212238,226,1,0,1,30,258
21232,972,0,92,0,886,1950
212326,0,0,0,0,36,36
212417,455,2,9,0,10,476
21246,5733,18,632,63,1042,7488
212613,611,0,0,0,7,618
21263,2615,57,184,0,43,2899
212637,37,0,0,0,8,45
212652,0,0,2,0,29,31
212665,266,0,10,0,0,276
21267,0,0,62,0,0,62
212696,62,4,26,0,66,158
21274,58,0,169,1,1,229
21283,7765,295,722,14,75,8871
212929,286,2,10,0,39,337
212949,0,0,0,0,0,0
212986,37,0,2,0,5,44
21305,82,6,89,0,2,179
213063,162,0,18,0,21,201
213089,126,0,0,1,1,128
21309,6096,265,578,24,904,7867
213111,236,5,4,0,228,473
213155,3,0,95,0,5,103
213260,2379,26,257,4,61,2727
21331,512,0,0,0,30,542
213347,243,0,0,9,16,268
213371,0,0,0,0,0,0
21348,1425,16,147,2,46,1636
21353,0,20,11,0,13,44
21367,105,0,0,0,0,105
21378,4,1,0,0,0,5
21413,9018,91,1566,46,624,11345
21418,48,16,0,6,0,70
21430,0,0,111,2,2,115
21453,0,92,11,0,0,103
21466,0,0,0,0,418,418
21473,1270,17,58,0,130,1475
21480,0,3,13,0,0,16
21502,178,0,85,1,60,324
21503,931,1,116,0,205,1253
21508,0,0,0,0,0,0
21515,165,0,4,0,17,186
2152,3561,34,262,33,390,4280
21527,0,0,0,0,0,0
21541,619,3,2,3,6,633
21545,10,1,2,0,0,13
21547,0,6,734,8,0,748
21548,1566,37,298,4,64,1969
21555,29,0,0,1,0,30
21564,6,0,0,18,0,24
21565,0,0,0,0,0,0
21570,10,0,0,0,0,10
21571,948,109,0,10,143,1210
21574,3682,124,0,108,1294,5208
21577,475,2,0,1,17,495
21612,318,176,60,10,3,567
21615,178,0,0,0,1,179
21632,1034,18,16,0,169,1237
21657,216,0,153,1,30,400
21668,0,0,0,0,0,0
21681,47,0,0,0,4,51
21694,10,0,19,0,0,29
217,0,0,0,0,0,0
21704,0,0,33,8,0,41
21708,0,0,0,1,0,1
21713,0,0,0,0,0,0
21724,56,0,0,0,0,56
21725,0,0,0,0,0,0
21730,0,0,0,0,0,0
21737,0,0,0,0,0,0
21743,1102,31,2,8,111,1254
21756,22,14,0,1,2,39
21757,0,0,19,0,0,19
21766,0,0,0,0,0,0
21777,286,1,0,0,114,401
21779,0,0,0,0,0,0
21782,0,0,0,0,0,0
21783,47,1,0,0,0,48
21788,0,34,74,12,0,120
21789,0,0,0,0,0,0
21803,0,0,0,0,0,0
21804,7720,254,216,21,2569,10780
21832,4,0,0,0,0,4
21837,41,0,0,0,37,78
21852,0,0,0,0,0,0
21859,11663,125,986,157,938,13869
21873,0,0,0,0,0,0
21887,702,6,4,49,72,833
21889,0,0,0,0,0,0
21891,1051,12,189,2,218,1472
21897,0,0,0,0,0,0
21898,0,0,0,0,0,0
21902,0,0,0,0,0,0
21921,4,0,0,0,0,4
21928,2628,112,989,93,1893,5715
21947,3647,87,255,28,758,4775
21949,638,0,24,0,20,682
21976,0,0,0,1,0,1
21981,2604,11,85,18,369,3087
21992,994,80,0,13,261,1348
2200,26,0,17,0,1,44
22006,0,0,0,0,0,0
22018,0,0,35,0,0,35
22047,5612,2351,570,75,3116,11724
22051,0,0,0,0,0,0
22054,847,262,119,32,690,1950
22068,0,0,0,0,0,0
22070,2455,8,25,4,362,2854
22079,453,6,46,0,24,529
22080,1596,150,18,9,45,1818
22085,6570,2006,431,13,838,9858
22110,194,0,133,0,0,327
22113,1120,23,46,0,242,1431
22121,446,2,20,0,48,516
22128,1733,6,0,5,202,1946
22138,0,0,0,0,0,0
22174,0,0,0,6,0,6
22177,1659,21,0,30,212,1922
22180,0,0,0,0,0,0
22186,0,0,0,0,0,0
22191,3399,49,537,12,1130,5127
22200,0,0,0,0,0,0
22217,0,0,0,0,0,0
22223,0,0,0,0,0,0
22245,0,0,0,0,0,0
22299,139,0,11,0,2,152
22302,291,0,161,3,0,455
22303,0,2,0,0,0,2
22315,4,0,0,1,0,5
22316,0,0,0,0,0,0
22320,0,0,0,0,0,0
22322,598,0,20,2,42,662
22324,0,0,0,1,0,1
22346,0,0,0,0,0,0
22351,58,5,72,4,5,144
22352,123,0,0,0,20,143
22353,0,0,0,0,0,0
22356,1671,10,143,2,50,1876
22363,180,1,2,0,3,186
22379,0,0,18,0,0,18
22381,2750,49,290,45,371,3505
22394,3805,293,417,17,938,5470
224,3371,50,42,1,473,3937
22402,0,0,0,0,0,0
22408,0,0,0,0,0,0
22413,0,0,0,0,0,0
22423,9426,1970,2702,143,6916,21157
22431,1807,5,0,4,230,2046
22442,0,0,0,0,0,0
22457,3099,205,471,27,966,4768
22464,0,0,0,0,0,0
22466,159,2,21,1,37,220
225,323,1,0,0,15,339
22501,545,343,85,42,116,1131
22504,0,0,0,0,0,0
22534,0,0,0,0,0,0
22561,5299,26,98,18,499,5940
22598,0,0,0,0,0,0
22608,707,39,134,17,189,1086
22612,0,0,0,0,0,0
22616,2190,655,180,61,591,3677
22631,0,0,164,1,0,165
22632,0,1,80,0,0,81
22639,3382,18,13,10,449,3872
22646,13,0,38,0,0,51
22647,1,0,0,0,0,1
22652,2179,10,1905,29,24,4147
22689,10917,157,480,62,2322,13938
22693,614,0,158,0,0,772
22706,880,2,0,10,33,925
22709,83,0,294,0,2,379
22725,0,0,0,0,0,0
22742,570,1,87,9,0,667
22765,0,0,13,0,0,13
22768,0,0,0,0,0,0
22772,0,0,0,0,0,0
22773,85127,1649,12236,888,29133,129033
22792,614,0,70,0,129,813
22799,2927,169,117,2,1018,4233
22800,0,0,0,0,0,0
22829,0,0,0,0,0,0
22834,254,0,0,0,0,254
22845,632,0,0,0,2,634
22884,880,47,239,25,355,1546
22887,0,0,0,0,0,0
22898,0,0,0,0,0,0
22909,0,0,0,0,0,0
22925,4562,286,609,8,907,6372
22926,0,0,24,0,0,24
22927,6123,2712,1010,197,2202,12244
22933,0,0,0,0,0,0
22935,0,0,0,0,0,0
22958,2,0,0,0,0,2
22987,839,9,6,4,25,883
22995,2356,55,47,23,649,3130
23005,75,4,0,0,1,80
23024,296,0,0,0,0,296
23033,1340,4,0,16,492,1852
23036,0,0,0,0,0,0
23074,0,14,22,7,0,43
23089,15,0,46,0,3,64
23102,113,0,0,0,0,113
23105,2338,5,0,6,187,2536
23106,2202,336,141,81,1457,4217
23118,3740,68,1353,32,1298,6491
23127,0,0,0,0,0,0
23138,624,13,4,1,65,707
23141,0,0,0,0,0,0
23148,0,0,0,0,0,0
23155,0,0,0,0,0,0
23158,0,0,0,0,0,0
23162,0,0,0,0,0,0
23175,1589,13,6,1,45,1654
23188,0,0,0,0,0,0
23201,12925,374,2258,151,4384,20092
23254,0,0,0,0,0,0
23260,0,0,0,0,0,0
23263,117,2,4,1,20,144
23265,1775,114,79,9,784,2761
23307,448,12,2,0,1,463
23308,0,0,0,0,0,0
23309,337,0,0,0,0,337
23314,4,0,0,0,0,4
23316,0,1,19,7,0,27
23404,0,0,0,0,0,0
23410,0,0,0,7,0,7
23415,0,0,0,0,0,0
23423,106,0,107,1,10,224
23432,0,0,17,0,0,17
23465,0,0,0,0,0,0
23470,0,0,0,4,0,4
23473,382,0,4,0,7,393
23481,0,0,0,0,0,0
23486,0,0,0,0,0,0
23492,341,3,0,0,13,357
23497,464,2,0,11,18,495
23498,63,0,0,0,0,63
23520,0,0,0,0,0,0
23523,0,0,0,0,0,0
23546,0,0,0,0,0,0
23563,10324,5,275,6,14,10624
23571,283,1,0,0,0,284
23575,245,0,2,0,0,247
23576,25,0,0,0,0,25
23578,1841,0,34,0,1,1876
23584,150,0,47,0,81,278
23585,0,0,0,0,0,0
23591,375,0,6,0,0,381
23601,12,0,0,0,0,12
23614,576,0,0,0,95,671
23618,1879,2,8,1,161,2051
23624,0,0,0,0,0,0
23629,0,0,0,0,0,0
23632,576,2,26,0,74,678
23650,958,32,6,2,73,1071
23666,81,0,0,0,0,81
23671,211,57,15,0,98,381
23673,285,572,198,34,0,1089
23678,0,80,210,2,0,292
23679,2334,73,139,11,93,2650
23682,1938,681,454,58,449,3580
23693,3699,24642,197,2069,7841,38448
23699,92,0,78,1,2,173
237,0,0,0,0,0,0
23700,7377,1026,24,227,5802,14456
23719,312,34,2,0,0,348
23724,11169,572,495,31,85,12352
23756,319,203,0,1,47,570
23767,44,0,58,0,0,102
23772,3190,1317,163,202,823,5695
23775,1086,5,6,5,283,1385
23778,3945,277,0,20,399,4641
23781,485,0,0,0,1,486
23783,0,0,0,0,148,148
23786,2691,291,28,7,581,3598
23788,0,0,0,0,0,0
2379,622,1,52,0,12,687
23791,0,0,0,0,732,732
23805,0,1,0,24,0,25
23807,353,0,0,0,28,381
23808,0,0,0,7,0,7
2381,0,0,0,0,0,0
23820,0,0,0,0,0,0
23836,701,0,0,0,47,748
23844,155,1,0,10,0,166
23853,1,0,32,0,0,33
23859,827,106,0,0,187,1120
2386,1109,20,309,43,138,1619
23860,995,1753,897,169,226,4040
23862,110,0,24,0,0,134
23884,0,97,0,1,0,98
23887,2333,2,14,13,66,2428
239,0,0,0,0,0,0
23908,226,0,0,0,1,227
23930,1094,2,88,23,50,1257
23944,12864,55,3447,94,910,17370
23949,1271,265,140,6,308,1990
23951,694,191,125,0,171,1181
23953,1838,69,130,5,216,2258
23959,0,0,0,4,245,249
23969,5386,13554,1319,818,1840,22917
23980,578,0,2,0,0,580
24023,0,0,0,0,0,0
24028,0,18,13,0,0,31
24033,2749,1220,617,24,1920,6530
24084,199,277,0,0,0,476
24085,3766,4,44,26,18,3858
24086,3172,2151,700,487,14486,20996
24088,3974,512,467,83,1288,6324
24090,0,1,6,0,0,7
24093,2244,446,175,58,672,3595
24138,1059,0,0,0,335,1394
24139,2302,63,0,0,1,2366
24154,1714,8,50,21,15,1808
24157,6178,184,64,158,453,7037
24158,4936,78,2,34,577,5627
24163,2690,88,89,122,1,2990
24164,8960,357,203,409,4,9933
24165,2178,67,22,71,4,2342
24173,9897,221,624,165,858,11765
24183,279,30,0,0,29,338
24186,1725,2379,1503,205,675,6487
24187,0,97,44,5,0,146
24200,531,30,103,0,218,882
24203,10868,6436,214,495,6314,24327
24204,519,26,2,0,86,633
24207,701,24,0,2,81,808
24211,391,158,143,22,281,995
24212,235,34,13,0,5,287
24213,228,22,8,1,0,259
24249,0,1,0,0,230,231
24251,0,0,0,3,0,3
24255,2339,42,0,4,586,2971
24259,79,0,0,0,0,79
24268,0,10,14,0,166,190
24271,0,0,0,0,0,0
24276,0,0,0,19,0,19
24282,577,1,0,18,91,687
24289,0,0,0,0,0,0
24295,558,0,0,0,40,598
24297,440,0,0,0,7,447
24309,46,9090,212,732,0,10080
24313,176,19,0,0,4,199
24314,0,21,0,0,0,21
24321,0,34,53,0,0,87
24334,858,1,0,0,6,865
24348,664,0,117,0,0,781
24349,430,2,0,6,1,439
24353,168,0,0,0,0,168
24355,49,0,0,0,0,49
24357,2375,26,14,2,1,2418
24358,397,42,4,6,4,453
24361,69,0,2,6,0,77
24362,107,0,0,0,1,108
24363,57,0,0,0,0,57
24364,3454,4,12,2,2,3474
24367,114,0,0,0,0,114
24371,39,0,0,1,0,40
24373,36,0,0,0,0,36
24378,0,1722,95,259,1,2077
24395,712,158,26,0,100,996
24400,122,509,136,10,1915,2692
24413,318,8,0,1,60,387
24416,5,0,0,0,0,5
24436,1523,237,0,21,285,2066
24441,1122,1,240,1,46,1410
24444,1104,113,117,6,129,1469
24445,4241,495,293,22,305,5356
24482,1016,389,114,12,433,1964
24492,2818,738,574,45,938,5113
24514,0,189,0,0,0,189
24516,492,66,0,0,12,570
24521,1707,116,197,1,557,2578
24523,678,16,0,1,142,837
24525,595,26,57,10,483,1171
24526,12,0,11,0,0,23
24527,802,119,162,2,137,1222
24529,438,123,144,11,204,920
24530,863,325,286,22,697,2193
24532,840,78,115,4,358,1395
24534,286,150,129,16,187,768
24535,1038,25,286,10,288,1647
24547,1119,201,44,0,1529,2893
24554,8915,5981,3702,765,4260,23623
24560,20463,25448,699,3062,7556,57228
24589,1212,120,663,4,118,2117
24620,49,0,24,0,1,74
24626,89,0,0,0,0,89
24641,0,0,13,0,0,13
24645,423,3,21,0,84,531
24651,764,257,356,7,342,1726
24663,272,20,29,0,0,321
24739,221,131,231,0,23,606
24750,0,0,21,0,83,104
24751,715,2,0,1,12,730
24753,272,1,0,0,21,294
24771,0,0,0,0,3,3
24792,64,1,0,0,25,90
24800,2378,14,637,5,157,3191
24889,0,0,2,0,0,2
24904,0,0,0,0,0,0
24921,1956,48,195,11,362,2572
24940,33652,1874,2417,915,11570,50428
2495,0,0,0,0,0,0
24953,582,1,42,0,37,662
24955,0,5,54,0,8,67
24961,0,0,180,0,0,180
2497,27208,2331,1033,108,2018,32698
24971,0,0,111,0,0,111
24978,188,0,0,0,0,188
25,700,5,0,0,124,829
25002,3538,9,477,2,170,4196
2501,0,0,0,0,83,83
25021,0,0,0,0,0,0
2504,147,1,2,2,7,159
25054,0,0,4,0,0,4
2506,2129,1,24,0,72,2226
2508,571,5,46,2,104,728
25094,263,0,0,1,2,266
2510,16135,3138,869,40,288,20470
25106,9629,388,1651,5,957,12630
25135,29,0,0,0,0,29
2514,30800,5097,1782,119,3486,41284
25144,378,1,155,12,922,1468
25147,69,0,75,23,83,250
25159,0,48,21,0,0,69
2516,101716,3490,2411,405,14133,122155
25176,1757,80,156,14,320,2327
2518,23631,2387,1685,71,3836,31610
25180,0,0,2,2,0,4
2519,331,30,8,44,212,625
25190,1697,14,88,12,393,2204
25206,411,0,153,0,203,767
25211,0,0,39,0,137,176
25222,428,261,144,23,541,1397
25227,0,29,110,0,0,139
25229,0,0,0,0,0,0
25248,0,2,380,0,59,441
25255,4687,402,877,43,554,6563
2527,1432,51,163,87,998,2731
2529,0,0,24,0,0,24
25291,880,0,51,0,5,936
25308,0,0,9,0,0,9
25310,0,0,2,0,0,2
25369,1,5,0,0,0,6
25374,147,0,318,0,303,768
25375,0,0,0,0,59,59
25387,477,0,0,0,3,480
25394,4146,282,376,0,51,4855
25400,7460,836,1427,29,1273,11025
25408,0,261,35,0,0,296
25415,0,0,26,0,0,26
25417,1139,3,110,2,243,1497
25424,5,0,207,0,13,225
2544,501,7,0,0,48,556
25441,7094,940,254,1,1456,9745
25446,163,5,0,0,0,168
25447,0,0,13,6,83,102
25454,1200,20,42,0,71,1333
25467,1,0,0,0,49,50
2547,0,0,0,0,0,0
25472,0,0,442,1,1102,1545
25490,0,20,0,0,0,20
25496,0,0,61,13,0,74
25512,30,0,658,5,49,742
25513,0,289,175,1,0,465
25515,191,157,243,5,0,596
2552,0,0,0,0,0,0
25528,870,14,19,1,12,916
2553,0,0,0,0,0,0
25540,131,0,0,0,0,131
25579,439,2,0,0,10,451
25596,0,0,96,0,0,96
25601,0,0,93,9,0,102
25637,0,0,0,0,0,0
25649,149,0,0,4,0,153
25651,0,0,0,0,0,0
25656,0,0,0,0,0,0
25660,0,0,0,0,0,0
25668,2946,530,87,16,1574,5153
25687,66,1,17,0,5,89
25697,91,1,0,0,18,110
25710,301,5,82,2,0,390
25715,0,0,0,0,0,0
25717,0,0,0,0,0,0
2572,0,0,0,0,0,0
25754,0,0,0,0,0,0
25764,990,25,88,4,467,1574
25769,0,0,0,0,0,0
25776,0,0,0,0,0,0
25779,0,0,0,0,0,0
25808,8,0,93,21,0,122
25820,2706,46,23,201,768,3744
25830,0,0,0,0,0,0
25832,1000,24,143,1,15,1183
25840,0,0,0,0,0,0
25843,0,0,0,0,0,0
25851,0,0,0,0,0,0
25853,1,0,19,0,0,20
2586,3599,65,238,32,501,4435
2588,2555,20,810,24,356,3765
25888,19,0,0,4,1,24
25899,4318,252,328,36,1464,6398
25905,494,6,0,1,75,576
25921,0,0,0,0,0,0
25928,0,0,0,0,0,0
25933,8536,217,148,98,1614,10613
25935,0,0,0,0,0,0
2594,433,0,71,0,2,506
25943,0,4,53,1,0,58
25950,0,0,0,0,0,0
25956,0,0,0,0,0,0
25961,2301,14,24,13,577,2929
25968,0,0,0,0,0,0
25969,0,0,0,0,0,0
25978,0,0,0,0,0,0
25979,0,0,0,0,0,0
26,0,0,0,1,0,1
2602,1364,1,4,0,26,1395
26046,0,0,0,0,0,0
2607,149,0,523,1,48,721
26076,169,0,11,0,0,180
26077,0,0,0,0,0,0
26088,793,7,70,13,113,996
2609,8157,506,914,107,1556,11240
26097,1110,46,432,7,297,1892
261050,380,1,0,1,0,382
2611,14,0,8,0,0,22
26110,0,0,0,0,0,0
26123,0,0,0,0,0,0
26133,4155,27,260,8,448,4898
2614,5910,78,1360,25,256,7629
26166,0,0,4,0,0,4
26174,0,0,0,0,0,0
26196,0,0,0,0,0,0
26198,795,1,2,0,10,808
26202,435,0,15,0,57,507
262150,411,291,0,23,29,754
262183,483,13,111,9,13,629
262187,528,200,265,19,77,1089
262189,190,151,10,10,76,437
262192,179,116,18,13,54,380
262194,154,112,144,10,8,428
262195,147,32,85,4,1,269
262196,783,131,166,0,46,1126
262208,314,147,99,13,51,624
262213,518,28,287,0,47,880
262216,339,137,146,22,39,683
262222,0,11,0,1,0,12
262229,480,110,278,6,52,926
26223,0,0,0,0,0,0
262230,178,83,68,21,27,377
262231,435,126,366,25,80,1032
262234,0,0,2,0,0,2
262259,361,261,147,55,133,957
262272,3620,61,403,68,667,4819
262282,284,9,0,4,114,411
262285,387,2,0,8,114,511
262286,837,28,0,15,104,984
262287,790,82,0,57,167,1096
262288,2068,329,0,76,695,3168
262290,681,10,141,18,182,1032
262292,984,1,0,0,16,1001
262294,478,9,141,9,199,836
262296,807,136,0,6,180,1129
262298,751,2,0,3,334,1090
262299,1001,17,0,12,292,1322
262301,906,10,0,6,31,953
262302,901,5,0,5,38,949
262306,444,7,0,4,124,579
262307,667,1,2,0,29,699
262308,1370,75,0,9,267,1721
262309,572,11,0,1,19,603
26231,264,4,15,18,79,380
262310,296,31,0,2,51,380
262311,756,11,139,9,120,1035
262313,991,8,0,7,347,1353
262314,1039,6,0,22,203,1270
262315,328,0,0,1,3,332
262316,2138,16,0,22,180,2356
262317,1354,12,0,12,330,1708
262318,3185,62,0,67,481,3795
262320,390,3,0,18,216,627
262322,988,33,2,77,529,1629
262324,918,8,205,2,51,1184
262325,309,6,0,4,104,423
262326,405,18,132,7,51,613
262330,255,14,100,4,46,419
262332,1085,19,428,4,212,1748
262333,797,24,0,25,337,1183
262334,668,8,139,9,144,968
262336,1751,4,242,2,215,2214
262342,1516,14,141,3,384,2058
262343,1271,2,141,9,311,1734
262344,440,7,262,10,39,758
262346,2266,2,392,8,85,2753
262351,262,46,282,12,82,684
262352,1586,39,488,27,499,2639
262353,282,0,0,0,4,286
262354,1323,20,149,16,265,1773
262355,993,18,0,12,60,1083
262360,2300,113,0,28,568,3009
262361,450,3,0,8,135,596
262362,819,7,37,11,148,1022
262363,581,1,0,3,34,619
262364,291,5,0,0,42,338
262365,889,13,0,7,183,1092
262367,379,94,144,19,204,840
262368,73,0,0,0,0,73
262369,781,37,233,29,81,1161
262372,203,30,0,10,70,313
262373,677,18,0,24,171,890
262374,1335,158,237,61,265,2056
262375,3749,33,100,35,284,4201
262376,517,40,0,9,100,666
262379,1010,8,0,11,74,1103
262380,878,3,141,0,35,1057
262381,401,9,0,14,58,482
262385,1285,17,0,10,114,1426
262387,2516,286,706,57,558,4123
262388,574,0,0,0,61,635
262391,2277,39,405,16,535,3272
262395,414,3,0,5,30,452
262398,564,0,0,3,102,669
262399,677,0,0,0,14,691
262401,1719,9,0,28,120,1876
262402,1341,3,0,5,174,1523
262403,540,93,0,22,157,812
262404,232,5,0,18,66,321
262405,431,2,0,9,65,507
262406,564,21,0,14,30,629
262407,1959,14,144,71,874,3062
262408,241,1,144,6,5,397
262411,534,3,0,4,99,640
262414,365,7,0,20,78,470
262416,862,4,0,2,69,937
262417,1331,50,0,40,298,1719
262418,1229,28,0,18,397,1672
262420,3306,36,0,45,715,4102
262422,803,0,0,2,22,827
262423,236,0,0,1,0,237
262424,1887,105,0,68,640,2700
262426,461,6,0,12,188,667
262428,2117,8,0,5,199,2329
262430,220,21,0,9,53,303
262433,819,14,0,14,216,1063
262434,2085,5,0,10,49,2149
262436,860,2,0,3,23,888
262437,1217,5,143,5,96,1466
262438,504,8,0,14,24,550
262439,671,3,0,12,105,791
26244,1,0,0,0,0,1
262444,1289,5,0,8,65,1367
262445,686,3,0,3,75,767
262447,410,61,0,5,102,578
262448,134,2,0,0,20,156
262450,287,115,0,4,25,431
262452,530,3,0,5,141,679
262453,187,1,0,0,66,254
262454,259,2,0,8,11,280
262457,769,2,0,6,34,811
262458,878,5,0,9,39,931
262459,977,61,144,51,385,1618
262461,1347,24,0,17,230,1618
262463,1527,9,0,12,236,1784
262464,1203,2,384,4,72,1665
262469,2450,36,0,49,902,3437
262470,3300,24,0,59,945,4328
262473,1021,3,0,2,460,1486
262474,434,24,0,24,92,574
262476,1967,26,144,2,639,2778
262478,857,7,0,4,158,1026
262480,500,4,0,22,242,768
262481,3385,24,533,39,585,4566
262482,1424,21,0,28,394,1867
262485,897,153,0,52,252,1354
262487,187,0,0,4,16,207
262488,2152,69,0,28,606,2855
262489,1347,8,257,12,95,1719
262492,26,2,0,0,1,29
262493,2500,38,121,30,645,3334
262494,5,1,0,0,4,10
262496,1995,6,0,3,158,2162
262497,781,18,0,10,19,828
262498,1079,121,0,18,135,1353
262502,1769,9,427,18,260,2483
262504,2435,66,0,14,44,2559
262505,899,10,0,2,307,1218
262506,498,10,0,11,202,721
262507,1009,38,0,33,279,1359
262509,1602,36,206,31,420,2295
262512,95,1,0,1,1,98
262514,1175,65,0,7,97,1344
262517,1151,6,0,1,195,1353
262519,720,95,168,19,152,1154
262522,782,17,0,5,119,923
262523,1404,6,0,3,151,1564
262526,1322,32,69,4,125,1552
262527,664,15,0,4,199,882
262529,81,1,0,1,0,83
262530,1398,7,0,2,210,1617
262531,784,1,0,16,83,884
262532,0,120,0,0,0,120
262535,1333,6,0,5,180,1524
262539,1013,3,0,3,41,1060
262540,378,4,0,3,51,436
262541,744,4,0,16,179,943
262542,1281,10,0,10,336,1637
262543,790,25,0,62,396,1273
262544,1537,13,141,17,407,2115
262546,1276,4,141,16,310,1747
262551,375,6,0,9,58,448
262557,725,71,0,22,169,987
262558,471,13,0,6,102,592
262561,356,35,0,8,51,450
262562,403,0,0,1,33,437
262565,1091,11,0,6,185,1293
262566,862,3,0,4,382,1251
262567,624,101,0,69,430,1224
262568,1117,14,0,10,74,1215
262571,150,72,0,2,120,344
262573,974,1,10,2,61,1048
262574,282,0,0,2,32,316
262575,1580,59,246,32,564,2481
262576,142,28,0,5,34,209
262577,380,2,0,0,14,396
262578,241,62,0,3,17,323
262579,371,1,0,0,40,412
26258,0,0,0,0,0,0
262581,313,2,0,0,28,343
262582,283,4,0,9,9,305
262584,397,5,0,3,9,414
262585,963,4,0,7,88,1062
262587,1480,9,144,9,236,1878
262588,1170,44,144,71,704,2133
262589,4200,149,527,112,631,5619
26259,538,0,0,1,38,577
262591,2723,21,294,45,349,3432
262592,728,4,0,4,71,807
262593,603,0,0,5,8,616
262594,595,3,0,8,218,824
262595,3745,25,139,40,768,4717
262596,795,6,0,23,99,923
262599,437,79,288,7,98,909
262600,707,2,0,1,141,851
262605,1744,37,0,16,315,2112
262606,822,22,0,37,252,1133
262607,1447,20,365,2,293,2127
262610,956,3,0,6,225,1190
262611,1164,37,144,17,359,1721
262612,1371,6,0,4,84,1465
262616,394,3,0,7,25,429
262617,1183,163,0,83,225,1654
262619,970,14,141,50,205,1380
262620,560,12,0,7,174,753
262621,582,2,0,0,74,658
262622,926,6,26,1,271,1230
262623,382,11,0,4,49,446
262624,1056,74,0,56,704,1890
262625,502,9,0,10,93,614
262627,180,1,0,1,12,194
262628,103,0,137,0,2,242
262630,685,1,0,0,13,699
262632,843,34,0,24,503,1404
262633,990,14,143,7,256,1410
262638,1322,7,141,22,122,1614
262641,947,2,288,4,181,1422
262643,1501,8,0,19,321,1849
262645,2166,97,101,72,806,3242
262646,878,33,132,31,299,1373
262648,152,12,0,9,70,243
262649,236,5,0,2,47,290
262650,587,2,0,0,48,637
262651,224,7,0,9,11,251
262656,228,30,131,3,41,433
262657,580,3,143,11,116,853
262659,2669,47,97,53,1049,3915
262660,933,29,141,5,190,1298
262661,901,2,0,11,39,953
262662,0,0,0,0,0,0
262663,1097,213,286,19,290,1905
262664,1131,202,143,26,295,1797
262665,949,2,0,4,48,1003
262668,2587,168,0,32,771,3558
262669,3749,16,226,22,806,4819
262671,365,1,0,1,9,376
262673,3021,691,280,51,1129,5172
262674,1383,7,0,1,21,1412
262675,1167,55,0,50,384,1656
262676,563,233,0,41,325,1162
262679,422,1,0,21,1,445
262680,1653,191,427,54,426,2751
262681,0,2,0,0,0,2
262682,1821,0,0,11,218,2050
262684,660,0,0,0,10,670
262685,678,127,0,40,259,1104
262686,847,1,0,2,25,875
262687,694,31,144,18,145,1032
262688,1399,9,0,41,55,1504
26269,1,0,301,30,0,332
262690,963,1,0,6,172,1142
262691,4380,11,141,6,442,4980
262692,834,3,0,3,121,961
262694,854,4,0,1,6,865
262695,983,5,0,1,38,1027
262696,1131,25,0,18,349,1523
262698,1246,2,143,6,149,1546
262699,1384,9,0,14,324,1731
262700,726,23,0,12,89,850
262702,989,29,0,34,514,1566
262704,1660,9,0,8,208,1885
262706,850,2,0,10,94,956
262708,804,1,0,0,42,847
262709,277,108,0,35,224,644
26271,0,0,111,0,0,111
262710,830,4,0,10,182,1026
262711,1253,0,0,0,39,1292
262714,95,17,0,13,21,146
262715,2310,21,573,30,659,3593
262719,975,8,139,3,101,1226
262720,1887,21,0,36,749,2693
262721,1396,5,234,6,123,1764
262722,1006,5,15,0,77,1103
262723,853,7,0,4,154,1018
262725,1547,35,0,18,403,2003
262728,888,6,0,4,47,945
262729,3448,11,141,11,502,4113
262730,5149,23,0,38,897,6107
262731,2234,151,0,78,980,3443
262732,2658,24,297,23,229,3231
262733,2021,5,4,8,246,2284
262734,602,83,0,12,194,891
262736,1034,14,0,12,450,1510
262737,432,60,0,4,221,717
262738,307,20,0,0,32,359
262739,226,43,0,18,58,345
262741,780,0,141,1,31,953
262743,819,6,414,18,369,1626
262744,1274,9,0,10,43,1336
262749,390,17,0,10,37,454
262750,1648,32,143,25,376,2224
262752,647,21,92,9,107,876
262754,1021,18,0,19,204,1262
262755,2044,5,2,19,136,2206
262756,1822,9,0,12,190,2033
262757,1373,1,143,3,20,1540
262758,733,5,0,5,61,804
262760,1799,54,0,40,758,2651
262761,1992,21,0,10,485,2508
262764,671,4,0,1,115,791
262765,1368,6,0,19,104,1497
262766,881,9,0,8,104,1002
262767,708,108,0,22,271,1109
262769,747,4,0,0,80,831
26277,9,5,0,0,0,14
262770,910,2,0,6,48,966
262772,972,7,0,16,34,1029
262774,1123,3,0,1,82,1209
262775,2179,12,198,19,233,2641
262777,2250,5,288,3,232,2778
262778,296,0,0,0,15,311
262779,1373,16,0,7,196,1592
262780,1462,2,2,0,181,1647
262781,81,0,0,1,2,84
262782,217,0,0,1,27,245
262784,2577,12,2,21,494,3106
262785,3935,30,570,36,290,4861
262789,819,2,0,5,29,855
262791,1315,48,0,49,462,1874
262793,161,11,0,2,25,199
262794,1801,5,288,6,180,2280
262797,1876,7,0,8,275,2166
262798,1065,4,0,4,169,1242
262799,901,69,2,26,118,1116
262801,12,2,0,0,3,17
262802,958,22,271,18,138,1407
262805,1078,2,0,10,60,1150
262806,1052,1,0,3,93,1149
262807,3462,172,852,117,1406,6009
262808,1514,542,0,101,806,2963
262809,1777,6,425,10,331,2549
262810,563,1,0,1,49,614
262812,1265,20,424,34,671,2414
262813,922,126,0,21,241,1310
262814,152,1,0,1,3,157
262815,663,2,87,2,25,779
262817,280,8,144,9,5,446
262819,1838,6,276,2,90,2212
262820,1156,12,143,20,597,1928
262821,262,3,141,3,210,619
262822,371,22,143,9,46,591
262824,1294,5,2,0,153,1454
262825,1369,18,0,19,159,1565
262826,476,0,0,3,40,519
262827,902,107,0,50,417,1476
262828,967,4,0,3,204,1178
262830,989,32,0,31,501,1553
262831,254,5,0,6,143,408
262833,760,2,0,1,14,777
262834,706,151,148,37,126,1168
262837,328,10,0,6,68,412
262838,829,58,0,54,314,1255
262839,807,6,0,2,91,906
262841,898,2,0,0,13,913
262842,499,4,0,1,41,545
262844,795,3,0,0,51,849
262846,595,2,0,2,24,623
262847,1283,16,149,26,237,1711
262848,2014,35,0,25,541,2615
262851,662,14,0,38,50,764
262854,1183,173,144,27,331,1858
262855,592,54,0,26,117,789
262856,605,1,0,10,64,680
262861,1571,12,143,9,174,1909
262862,2271,39,288,37,708,3343
262863,401,1,0,0,22,424
262865,2454,22,121,12,148,2757
262866,962,3,0,1,59,1025
262867,400,1,0,13,18,432
262868,257,0,144,0,9,410
262869,380,3,0,3,58,444
262871,68,9,139,0,79,295
262873,172,1,0,4,33,210
262875,281,0,0,0,48,329
262877,1248,3,0,7,104,1362
262878,403,12,0,3,2,420
262879,1170,13,0,25,121,1329
262880,1130,5,141,23,139,1438
262881,426,2,195,1,27,651
262883,1508,9,144,9,270,1940
262886,516,1,0,0,22,539
262888,205,55,0,0,4,264
262889,598,3,0,8,212,821
262890,996,22,0,6,317,1341
262891,1538,22,0,6,165,1731
262892,635,7,0,4,160,806
262893,1796,51,287,32,170,2336
262895,923,4,138,5,105,1175
262898,313,117,0,5,165,600
262900,1010,1,0,0,19,1030
262902,526,0,0,2,175,703
262903,1739,8,0,3,309,2059
262905,872,0,145,6,25,1048
262906,272,4,0,0,24,300
262907,8168,163,574,115,2110,11130
262908,1125,1,0,1,119,1246
262909,863,0,0,0,22,885
262911,712,2,0,0,91,805
262913,29,0,193,18,2,242
262916,0,0,0,0,0,0
26292,3,1,70,21,0,95
262932,639,126,4,13,142,924
262934,71,4,47,1,0,123
262935,3,3,23,0,1,30
262937,382,13,0,14,128,537
262940,493,6,0,12,152,663
262943,370,12,0,4,53,439
262945,196,68,0,7,33,304
262949,625,9,282,7,71,994
262950,387,56,0,29,87,559
262952,1823,3,220,3,75,2124
262953,425,5,0,13,141,584
262955,769,6,285,9,225,1294
262957,291,2,0,0,6,299
262958,1006,9,250,15,69,1349
262960,304,53,0,0,76,433
262961,893,4,0,10,100,1007
262964,101,12,0,3,7,123
262966,865,2,21,2,24,914
262970,289,42,0,36,233,600
262972,735,7,0,8,17,767
262973,1014,8,0,8,287,1317
262977,1547,35,0,9,205,1796
262979,1323,7,0,22,239,1591
262982,1457,18,285,19,401,2180
262983,4573,25,144,9,488,5239
262986,864,1,0,1,62,928
262988,1119,7,0,6,384,1516
262989,203,10,144,2,6,365
262992,966,18,137,7,59,1187
262993,1235,5,404,2,87,1733
262995,1068,19,141,24,545,1797
262996,816,11,0,13,315,1155
262999,62,13,0,1,22,98
263002,1032,2,0,1,164,1199
263003,875,17,39,35,185,1151
263004,737,1,143,2,50,933
263005,411,0,0,1,11,423
263006,950,8,0,5,114,1077
263008,249,89,0,4,22,364
263009,263,76,0,0,86,425
263010,854,1,144,0,59,1058
263011,810,35,0,28,546,1419
263015,2252,4,413,8,112,2789
263018,242,1,0,0,22,265
263019,575,11,0,19,93,698
263020,1181,14,394,5,121,1715
263027,731,17,0,15,317,1080
263028,863,2,0,3,111,979
263029,519,2,0,1,76,598
263030,756,1,141,5,5,908
263031,89,1,0,1,2,93
263032,1482,22,271,13,209,1997
263033,458,162,0,29,282,931
263035,524,27,0,19,313,883
263036,377,2,0,1,18,398
263037,1909,4,286,1,61,2261
263038,116,0,0,0,5,121
263039,87,12,0,1,9,109
263040,1123,21,0,48,205,1397
263041,33,2,0,0,1,36
263042,941,6,0,1,15,963
263043,1085,4,0,0,79,1168
263046,602,8,0,10,164,784
263047,864,214,0,68,343,1489
263048,383,0,0,0,78,461
263052,402,0,0,5,5,412
263053,720,3,0,0,66,789
263054,766,57,0,12,80,915
263055,1473,4,0,4,114,1595
263056,427,1,0,0,43,471
263057,462,74,144,4,125,809
263058,761,3,0,0,59,823
263059,258,0,0,6,2,266
263060,404,0,0,0,2,406
263067,439,26,0,9,212,686
263069,474,1,0,5,55,535
263070,1608,22,288,3,127,2048
263072,750,48,141,24,308,1271
263073,1371,61,143,17,143,1735
263075,594,1,0,0,60,655
263077,3655,25,134,21,359,4194
263080,962,7,393,3,44,1409
263081,217,29,0,4,53,303
263084,843,2,6,17,140,1008
263087,1782,51,0,21,720,2574
263089,676,32,0,11,169,888
263090,377,1,0,0,39,417
263091,126,1,0,4,7,138
263097,312,10,0,8,79,409
263099,1648,163,432,25,345,2613
263100,112,0,0,4,1,117
263101,752,20,0,39,157,968
263102,426,35,0,32,174,667
263104,763,2,0,6,189,960
263105,325,0,0,0,3,328
263106,397,11,139,1,40,588
263107,952,15,0,12,360,1339
263108,409,73,0,29,187,698
26311,440,4,137,4,32,617
263110,1514,21,432,21,372,2360
263111,447,1,0,1,1,450
263112,167,38,0,2,46,253
263116,122,30,0,1,49,202
263119,4,0,0,0,1,5
263120,805,10,0,18,242,1075
263121,527,3,0,2,42,574
263124,770,14,141,22,175,1122
263125,243,25,0,0,66,334
263126,42,0,0,1,2,45
263130,619,135,0,7,159,920
263131,469,8,0,5,137,619
263133,453,2,0,0,2,457
263135,689,9,0,3,167,868
263139,81,0,141,2,4,228
263140,288,0,0,0,4,292
263142,628,1,0,2,15,646
263145,304,89,0,22,141,556
263151,909,4,242,2,119,1276
263152,2449,26,141,14,365,2995
263153,347,102,0,4,57,510
263154,1146,2,0,4,313,1465
263155,417,26,0,13,188,644
263156,410,13,0,15,157,595
263157,0,0,0,0,0,0
263159,200,4,0,1,78,283
263164,189,18,0,24,8,239
263166,796,1,100,1,27,925
263172,120,46,2,1,1,170
263173,62,10,0,0,0,72
263181,189,66,2,3,38,298
263190,93,35,25,6,6,165
263194,164,99,0,13,44,320
263196,348,213,58,27,99,745
263197,171,75,77,17,2,342
263209,487,137,195,0,68,887
263213,77,36,0,4,13,130
263219,253,155,197,21,92,718
263221,131,32,89,8,16,276
263230,949,321,96,73,191,1630
263233,293,100,98,27,34,552
263236,304,30,6,0,34,374
263244,829,199,432,9,50,1519
263250,1530,86,423,38,381,2458
263251,574,5,76,10,51,716
263252,269,14,196,9,88,576
263263,469,2,108,8,20,607
263264,498,3,0,4,3,508
263265,856,5,0,19,236,1116
263266,875,1,0,1,53,930
263269,662,17,0,22,251,952
26327,1085,56,328,31,195,1695
263270,517,4,0,8,16,545
263272,117,57,0,1,39,214
263274,375,9,0,6,7,397
263275,59,0,0,0,1,60
263276,34,22,0,0,0,56
263277,393,1,0,4,24,422
263280,714,2,0,1,190,907
263281,610,0,0,0,40,650
263284,60,0,0,0,10,70
263285,142,0,0,1,37,180
263286,378,0,0,0,3,381
263289,1350,35,0,29,490,1904
263290,622,0,0,13,180,815
263291,885,87,0,14,171,1157
263293,4,1,0,0,0,5
263296,413,17,144,16,111,701
263297,1196,4,0,8,69,1277
263298,546,0,0,0,9,555
263304,202,16,0,1,27,246
263305,473,27,0,14,198,712
263310,658,6,0,23,188,875
263314,861,5,0,16,244,1126
263317,295,0,0,0,1,296
263320,1070,50,0,27,622,1769
263322,790,8,0,1,129,928
263324,484,99,143,40,183,949
263326,162,2,0,0,2,166
263327,374,78,0,0,150,602
263328,674,103,144,49,531,1501
263329,586,37,0,24,196,843
263331,895,25,0,30,191,1141
263332,135,8,0,10,88,241
263333,1005,11,0,12,457,1485
263334,318,3,0,0,6,327
263336,868,39,0,6,252,1165
263338,138,1,0,0,29,168
263339,496,94,0,37,320,947
263341,943,20,144,10,209,1326
263344,228,7,0,0,21,256
263345,300,23,0,0,58,381
263347,1098,51,0,48,923,2120
263348,261,3,0,14,59,337
263349,631,9,0,7,238,885
26335,0,0,0,0,0,0
263350,552,0,0,0,91,643
263351,337,34,0,23,29,423
263352,445,1,0,7,20,473
263353,247,2,0,5,34,288
263356,514,6,0,7,123,650
263357,638,34,0,8,43,723
263359,613,9,0,6,123,751
263360,315,0,0,0,1,316
263361,1383,62,157,46,361,2009
263363,547,86,0,7,184,824
263370,332,2,0,2,51,387
263371,695,25,0,27,336,1083
263374,881,39,0,31,270,1221
263375,532,10,0,0,106,648
263378,664,0,0,0,13,677
263380,414,110,0,9,113,646
263382,594,50,0,6,68,718
263384,804,4,139,7,154,1108
263385,266,0,0,0,3,269
263387,249,17,0,4,71,341
263388,630,1,0,10,49,690
263389,279,5,0,1,19,304
263390,609,126,0,20,195,950
263391,922,2,61,14,31,1030
263393,776,4,0,8,56,844
263394,101,3,0,1,43,148
263395,334,17,0,8,51,410
263398,259,2,0,1,7,269
263400,337,13,0,4,126,480
263401,503,2,0,4,121,630
263402,973,56,0,19,232,1280
263404,598,7,0,3,105,713
263405,1446,24,143,49,271,1933
263408,409,1,0,0,33,443
263411,328,105,0,34,72,539
263412,573,1,0,0,56,630
263415,1176,15,144,18,123,1476
263416,94,2,0,1,43,140
263418,335,8,0,3,168,514
263419,479,2,0,0,134,615
263420,451,12,2,14,62,541
263421,1069,6,574,19,117,1785
263423,522,24,0,7,163,716
263424,1014,21,369,12,293,1709
263426,282,5,37,1,142,467
263427,187,1,0,5,5,198
263431,297,23,0,6,233,559
263432,1199,25,0,36,743,2003
263433,648,13,0,5,150,816
263435,196,0,0,1,0,197
263436,1204,10,0,16,382,1612
263437,749,17,0,1,123,890
263439,901,4,144,7,219,1275
263440,438,0,0,0,109,547
263441,1393,16,428,15,218,2070
263442,1170,37,0,22,356,1585
263445,526,1,0,2,30,559
263446,267,31,0,8,81,387
263451,258,0,0,0,18,276
263453,885,19,0,3,244,1151
263456,232,19,0,4,59,314
263459,644,10,0,13,29,696
263462,609,15,0,11,77,712
263463,185,12,0,0,40,237
263464,352,31,0,4,82,469
263466,930,4,0,1,166,1101
263467,1020,17,0,23,534,1594
263469,85,0,0,0,0,85
26347,0,0,0,19,0,19
263470,908,2,150,9,204,1273
263471,980,30,144,46,391,1591
263475,456,13,0,24,135,628
263476,206,87,0,32,134,459
263478,1078,12,143,8,171,1412
263481,864,16,0,20,193,1093
263482,489,16,132,4,59,700
263483,554,11,0,0,82,647
263484,442,173,0,47,174,836
263485,251,1,0,11,9,272
263486,1202,5,0,1,131,1339
263487,406,35,0,20,99,560
263489,907,7,0,5,35,954
263490,625,27,0,15,132,799
263492,715,32,0,9,240,996
263493,329,5,0,1,138,473
263494,268,2,0,1,51,322
263495,651,5,144,2,27,829
263496,1004,4,0,1,117,1126
263497,603,1,0,0,12,616
263498,724,1,144,0,17,886
263499,429,138,0,54,209,830
263503,498,2,0,0,59,559
263504,855,5,0,17,147,1024
263507,558,4,0,0,56,618
263508,892,0,0,0,94,986
263509,1231,3,0,5,129,1368
263510,328,5,0,3,13,349
263512,776,21,0,42,345,1184
263513,327,1,0,8,39,375
263514,105,12,0,0,10,127
263516,440,25,0,19,260,744
263518,878,5,282,7,95,1267
263519,39,0,0,1,51,91
263520,1153,11,278,21,289,1752
263524,732,24,0,32,369,1157
263525,1485,24,0,39,728,2276
263526,404,31,0,22,70,527
263527,730,7,0,5,195,937
263530,926,23,134,3,106,1192
263531,847,0,0,0,121,968
263532,728,9,0,12,81,830
263535,1045,12,0,12,176,1245
263536,740,6,0,4,68,818
263537,558,15,0,6,160,739
263538,246,1,0,1,159,407
263539,503,10,0,12,208,733
263541,632,3,0,1,139,775
263542,363,3,0,14,8,388
263543,921,22,11,22,258,1234
263544,1841,30,144,33,584,2632
263545,165,19,0,0,39,223
263548,635,1,0,0,12,648
263549,282,26,0,4,21,333
263551,417,3,0,11,38,469
263553,83,0,2,7,2,94
263554,602,5,123,14,8,752
263555,697,2,278,5,63,1045
263557,746,10,0,18,142,916
263558,868,3,0,1,306,1178
263561,186,1,0,1,64,252
263562,441,0,0,0,52,493
263565,1392,47,0,25,191,1655
263567,629,2,0,0,57,688
263569,1239,37,144,34,454,1908
263570,182,13,0,0,2,197
263573,932,2,143,8,47,1132
263574,1141,36,0,41,306,1524
263577,157,0,0,0,2,159
263578,925,11,0,5,301,1242
263579,464,0,0,1,164,629
263580,14,1,0,0,2,17
263581,1097,50,0,32,608,1787
263582,1459,4,0,7,272,1742
263583,545,27,0,33,287,892
263585,617,300,0,33,394,1344
263586,1404,37,139,17,271,1868
263587,1522,6,266,3,374,2171
263589,2057,20,150,32,307,2566
263591,295,1,0,7,19,322
263594,500,2,0,8,111,621
263595,872,24,0,17,338,1251
263598,774,1,0,0,31,806
263599,890,0,0,2,106,998
263600,693,10,0,20,197,920
263601,373,2,0,3,27,405
263603,618,3,208,1,42,872
263604,810,9,19,11,192,1041
263608,1053,11,144,13,187,1408
263609,324,5,0,3,25,357
263614,371,0,0,5,21,397
263616,1835,12,139,17,295,2298
263619,290,1,0,0,1,292
263620,841,3,0,10,179,1033
263623,1301,4,139,21,269,1734
263624,520,7,0,10,220,757
263625,625,33,0,26,178,862
263626,1044,7,0,20,180,1251
263627,1289,14,303,3,186,1795
263629,175,16,148,6,15,360
263631,362,3,144,14,51,574
263632,991,27,0,9,154,1181
263633,228,1,0,1,23,253
263634,1060,5,0,11,57,1133
263635,353,1,0,2,4,360
263636,955,6,0,1,90,1052
263640,1108,20,0,17,174,1319
263641,783,1,0,12,116,912
263643,235,1,0,1,130,367
263645,658,32,0,48,363,1101
263646,681,13,283,18,32,1027
263647,739,15,0,5,104,863
263648,731,7,0,5,105,848
263649,1997,43,570,13,266,2889
263650,428,0,144,2,16,590
263652,339,3,0,0,9,351
263653,1492,22,280,20,492,2306
263656,1194,16,4,6,95,1315
263657,498,1,0,7,28,534
263659,609,0,0,4,64,677
263663,899,1,0,6,112,1018
263667,91,5,0,1,1,98
263668,49,1,147,0,0,197
26367,0,0,0,0,0,0
263672,311,2,0,0,8,321
263674,832,0,0,0,11,843
263675,859,19,0,12,394,1284
263676,532,0,0,1,83,616
263684,543,212,0,46,103,904
263687,384,186,144,27,53,794
263693,347,137,150,22,15,671
263699,858,74,146,0,28,1106
2637,0,0,0,0,0,0
263702,382,108,269,18,77,854
263704,240,92,144,15,31,522
263712,169,115,0,10,78,372
263715,282,104,35,15,72,508
263716,156,82,144,7,20,409
263717,1981,44,128,31,326,2510
263720,136,70,0,14,25,245
263726,410,131,144,28,81,794
263728,37,14,0,1,2,54
263729,174,84,56,9,22,345
263732,578,13,0,1,51,643
263735,0,0,70,4,0,74
263736,295,88,285,3,20,691
263737,175,109,0,27,42,353
263739,210,100,0,7,19,336
263740,0,0,0,25,0,25
263741,164,85,0,5,64,318
263742,48,46,2,5,42,143
263746,169,118,144,26,49,506
26375,0,0,0,0,0,0
263750,569,0,0,0,3,572
263754,155,52,0,4,17,228
263755,162,83,0,11,31,287
263756,185,89,0,11,23,308
263757,146,23,0,4,9,182
263764,383,43,285,5,63,779
263766,314,141,150,17,55,677
263768,207,61,208,3,15,494
263769,478,244,116,11,104,953
263774,440,76,0,11,135,662
263775,157,23,144,3,11,338
263776,296,59,144,11,48,558
263777,303,36,288,3,12,642
263778,178,140,93,22,62,495
263780,269,69,0,1,16,355
263782,103,44,144,6,8,305
263786,285,51,261,8,16,621
263789,84,77,0,1,20,182
263790,144,13,0,4,14,175
263791,343,170,144,26,117,800
263793,409,166,148,34,123,880
263800,253,95,0,16,42,406
263801,328,198,156,27,75,784
263808,142,42,0,7,29,220
263809,401,228,285,26,71,1011
263811,164,92,109,8,30,403
263813,94,0,38,0,2,134
263814,151,75,26,20,22,294
263815,111,24,0,11,3,149
263822,237,56,144,1,54,492
263823,43,7,0,3,7,60
263827,135,46,98,10,17,306
263829,0,0,0,0,0,0
263833,148,3,144,0,2,297
263834,531,34,0,5,60,630
263847,577,23,144,20,298,1062
263848,571,19,139,16,216,961
263849,142,2,283,10,109,546
263852,304,101,0,36,103,544
263853,238,6,170,4,12,430
263854,99,0,0,0,2,101
263855,339,22,281,15,134,791
263858,372,9,0,18,162,561
263863,465,5,198,0,80,748
263864,869,87,0,48,363,1367
263868,588,3,171,5,118,885
263869,207,1,9,0,5,222
263877,657,21,0,16,207,901
263879,164,35,144,17,80,440
263884,177,17,0,6,33,233
263885,317,0,139,0,15,471
263886,239,57,0,26,106,428
263888,428,15,116,12,93,664
263891,828,6,144,15,73,1066
263895,144,10,144,1,54,353
263896,289,1,144,4,115,553
263897,428,16,0,1,156,601
263899,274,61,15,0,7,357
263900,377,3,265,0,51,696
263902,51,2,0,0,9,62
263903,420,35,287,10,73,825
263904,957,7,436,26,152,1578
263905,356,59,323,30,75,843
263906,554,4,0,4,80,642
263908,268,62,279,27,97,733
263910,540,9,0,15,120,684
263911,336,1,2,6,56,401
263912,948,11,288,11,156,1414
263914,144,8,139,6,98,395
263915,153,6,427,1,13,600
263918,385,1,283,1,7,677
263919,124,18,4,11,35,192
263922,272,6,0,1,56,335
263924,255,0,0,1,13,269
263927,275,0,0,0,5,280
263928,0,0,225,0,0,225
263931,42,1,0,0,1,44
263932,432,4,282,2,38,758
263937,287,1,22,3,3,316
263941,472,13,288,10,206,989
263942,84,0,135,0,1,220
263944,527,7,139,6,140,819
263945,132,16,0,1,44,193
263946,342,42,139,11,43,577
263948,628,20,0,25,115,788
263949,580,1,96,1,53,731
263950,258,79,0,28,114,479
263951,156,1,0,1,11,169
263954,257,58,144,6,94,559
263958,480,38,546,8,90,1162
263959,610,24,167,27,354,1182
263962,361,4,0,3,52,420
263963,806,6,0,11,95,918
263964,576,22,288,3,159,1048
263965,215,5,114,2,32,368
263966,216,23,144,13,155,551
263967,405,26,139,17,108,695
263968,347,30,0,0,5,382
263971,803,7,215,13,162,1200
263972,171,10,0,0,2,183
263973,454,1,282,5,60,802
263976,349,8,0,6,42,405
263977,287,3,144,2,74,510
263979,636,7,0,18,161,822
263982,541,54,0,12,142,749
263983,493,1,144,0,63,701
263984,396,3,144,0,31,574
263985,446,9,0,16,295,766
263988,288,3,144,24,3,462
263989,537,7,280,5,68,897
263990,396,34,0,41,243,714
263991,1029,14,13,14,180,1250
263993,726,31,139,1,194,1091
263994,306,7,0,7,34,354
263996,361,1,139,4,64,569
263998,1231,21,0,13,296,1561
26400,0,0,0,0,0,0
264000,625,1,0,5,98,729
264001,1392,42,0,15,218,1667
264002,283,9,0,7,117,416
264004,259,0,0,0,11,270
264005,820,11,0,14,79,924
264007,349,1,0,2,52,404
264008,915,21,0,24,340,1300
264009,1127,11,0,10,66,1214
264010,297,4,0,0,3,304
264013,623,0,144,5,49,821
264014,290,20,0,19,107,436
264015,175,0,0,0,1,176
264016,870,3,0,2,52,927
264017,493,1,0,2,47,543
264023,43,0,0,0,2,45
264024,164,3,0,4,2,173
264025,439,13,119,4,61,636
264026,423,9,0,10,169,611
264027,697,5,144,1,15,862
264030,346,0,0,0,11,357
264031,387,0,0,0,24,411
264032,210,35,0,18,50,313
264035,279,23,0,2,6,310
264045,238,1,139,3,64,445
264053,115,1,141,0,15,272
264054,0,11,0,5,0,16
264055,382,0,0,0,9,391
264056,335,5,141,3,55,539
264060,179,1,144,15,6,345
264064,577,1,0,3,34,615
264065,125,6,2,2,4,139
264066,318,1,283,0,5,607
264067,578,3,334,0,37,952
264069,946,11,285,37,112,1391
264071,479,10,144,10,89,732
264073,480,1,143,4,44,672
264074,310,2,134,3,16,465
264075,176,18,0,4,27,225
264076,440,10,144,11,95,700
264078,425,0,0,0,9,434
264086,495,9,0,12,104,620
264090,385,37,280,10,81,793
264092,138,22,133,4,3,300
264093,130,2,0,7,36,175
264096,336,35,285,17,88,761
264100,1711,151,554,50,430,2896
264104,148,23,0,7,61,239
264106,907,23,144,24,228,1326
264111,363,67,0,21,97,548
264112,919,8,0,22,93,1042
264114,1086,31,144,22,117,1400
264116,109,2,0,3,6,120
264117,1033,25,0,24,270,1352
264118,119,2,0,4,23,148
264119,449,13,0,11,4,477
264120,52,0,0,0,0,52
264121,49,2,0,0,6,57
264125,25,0,0,1,2,28
264126,428,5,0,4,52,489
264127,226,10,0,7,81,324
264129,477,1,0,0,30,508
264130,41,0,144,6,1,192
264133,468,15,0,21,101,605
264134,306,7,0,4,21,338
264135,378,6,0,13,82,479
264138,129,14,0,0,17,160
264144,371,1,143,0,18,533
264146,301,2,0,0,13,316
264147,635,12,0,18,242,907
264148,357,30,0,6,80,473
264149,673,0,0,0,156,829
264150,491,82,141,19,191,924
264152,485,7,144,12,122,770
264153,146,16,0,19,4,185
264155,35,0,144,0,1,180
264157,262,2,0,12,77,353
264160,316,84,0,25,143,568
264162,302,95,144,38,154,733
264163,549,8,0,15,55,627
264164,872,1,124,1,53,1051
264171,99,0,0,0,12,111
264172,208,2,4,1,3,218
264180,352,1,144,6,90,593
264181,69,8,0,5,2,84
264186,612,20,144,21,202,999
264187,149,1,144,0,65,359
264191,263,1,266,0,6,536
264193,140,0,0,0,0,140
264194,412,22,0,17,136,587
264197,105,9,144,7,23,288
264202,765,3,139,7,81,995
264203,415,2,144,4,36,601
264206,401,12,146,19,100,678
264207,212,9,0,4,52,277
264209,44,5,0,6,40,95
26421,0,0,0,0,0,0
264210,346,9,125,8,135,623
264212,501,33,17,2,79,632
264214,524,0,0,0,16,540
264215,71,11,120,6,8,216
264216,588,3,147,8,251,997
264217,411,12,144,16,239,822
264219,174,41,237,12,91,555
264223,452,33,0,45,306,836
264224,524,1,0,0,35,560
264227,574,10,0,7,257,848
264228,674,19,144,9,215,1061
264229,168,18,0,8,36,230
264230,487,4,143,5,51,690
264232,515,9,0,27,159,710
264233,619,1,0,1,14,635
264234,529,10,132,12,177,860
264235,367,5,0,6,59,437
264236,676,1,144,1,224,1046
264238,1416,46,285,30,467,2244
264242,328,0,291,0,28,647
264244,330,18,144,8,100,600
264245,316,13,144,20,46,539
264246,372,0,134,0,90,596
264248,232,0,138,1,17,388
264250,423,1,0,4,33,461
264253,1,0,139,0,0,140
264255,790,33,567,36,397,1823
264260,476,34,0,30,272,812
264262,332,2,0,0,19,353
264263,436,16,0,23,164,639
264264,1,0,0,0,0,1
264265,316,10,0,8,121,455
264266,425,10,0,1,43,479
264267,545,2,0,1,101,649
264268,167,3,0,1,5,176
264270,625,0,288,10,188,1111
264272,326,68,0,16,100,510
264274,493,0,0,0,13,506
264278,581,18,0,0,54,653
264279,47,0,0,0,0,47
264280,435,2,0,3,41,481
264281,773,17,0,8,26,824
264282,488,12,0,7,137,644
264283,18,0,0,1,113,132
264284,554,21,0,31,76,682
264285,582,10,0,4,74,670
264286,316,1,144,6,28,495
264290,974,4,0,2,53,1033
264295,926,2,2,1,27,958
264297,190,40,0,16,61,307
264298,551,6,0,18,99,674
264299,1006,1,288,4,32,1331
264301,239,47,295,10,108,699
264308,487,14,144,10,68,723
264311,131,2,0,1,3,137
264316,557,2,139,0,33,731
264318,416,37,0,5,93,551
264321,721,8,327,11,63,1130
264322,364,3,0,6,49,422
264323,441,21,276,0,42,780
264324,192,0,427,0,2,621
264326,481,18,240,32,173,944
264327,380,5,0,4,131,520
264328,336,5,144,14,74,573
264332,407,26,0,26,139,598
264334,428,2,288,0,33,751
264335,253,32,283,8,37,613
264337,245,17,227,8,52,549
264342,669,0,274,2,21,966
264343,86,1,0,0,6,93
264346,115,2,0,0,19,136
264349,1000,27,144,20,284,1475
264350,637,8,143,19,143,950
264351,590,8,0,10,236,844
264352,285,1,0,0,4,290
264353,785,1,270,1,19,1076
264356,957,3,0,7,103,1070
264358,171,0,0,7,5,183
264360,871,11,279,9,47,1217
264362,469,3,144,3,252,871
264364,461,3,0,1,13,478
264366,149,1,2,0,5,157
264367,1299,10,143,29,229,1710
264368,418,8,274,5,81,786
264375,184,1,0,0,2,187
264381,1429,28,0,29,230,1716
264382,691,11,141,30,245,1118
264384,240,26,0,1,58,325
264385,222,0,0,7,7,236
264386,1063,60,287,41,567,2018
264389,508,19,141,29,194,891
264390,346,6,288,4,17,661
264391,290,19,0,26,52,387
264392,407,9,144,8,36,604
264393,327,5,285,2,73,692
264402,250,29,429,16,51,775
264404,793,6,556,4,26,1385
264406,59,1,0,4,4,68
264407,509,8,141,20,113,791
264411,229,14,0,0,15,258
264412,291,2,0,0,15,308
264413,424,1,0,3,14,442
264414,520,8,0,16,14,558
264417,254,4,0,4,27,289
264422,108,19,0,6,8,141
264425,371,31,0,40,197,639
264426,1726,14,4,35,411,2190
264428,760,2,0,0,10,772
264429,533,94,288,41,118,1074
264433,64,0,144,0,2,210
264434,339,1,0,0,26,366
264435,38,1,144,0,2,185
264437,279,13,0,11,37,340
264440,1560,31,143,43,301,2078
264441,190,7,0,10,11,218
264442,685,62,0,35,169,951
264443,270,15,0,15,100,400
264449,468,21,0,6,263,758
264450,451,3,0,3,171,628
264453,411,6,144,4,11,576
264455,157,4,0,8,33,202
264458,477,14,143,9,133,776
264459,309,4,144,2,14,473
264463,500,0,0,4,143,647
264464,91,2,141,0,4,238
264472,370,6,0,1,61,438
264477,315,75,147,9,95,641
264478,772,7,416,3,80,1278
264479,175,158,0,1,151,485
264480,552,4,0,0,115,671
264483,159,18,0,5,39,221
264484,450,1,0,9,4,464
264485,718,84,144,26,177,1149
264486,858,6,0,11,138,1013
264487,250,82,0,22,149,503
264490,519,3,0,5,145,672
264491,715,15,100,6,72,908
264492,526,9,141,27,159,862
264497,381,4,0,0,42,427
264500,263,48,0,23,99,433
264502,673,0,278,0,257,1208
264504,114,6,0,5,52,177
264508,1013,3,286,18,64,1384
26451,0,0,0,0,0,0
264510,186,12,0,2,40,240
264513,388,28,0,0,65,481
264514,400,2,284,13,50,749
264516,0,0,0,0,0,0
264517,698,6,0,2,117,823
264518,147,65,0,19,101,332
264523,160,66,0,24,118,368
264524,576,5,0,29,149,759
264526,236,1,0,1,18,256
264527,229,59,99,26,56,469
264530,287,5,141,1,27,461
264533,174,11,0,4,72,261
264536,253,3,0,1,65,322
264537,34,1,0,0,1,36
264538,536,15,0,17,257,825
264542,91,6,278,1,1,377
264543,965,8,146,8,200,1327
264544,593,8,0,12,55,668
264547,938,8,283,12,210,1451
264548,232,2,0,0,1,235
264550,1140,30,143,32,354,1699
264551,191,7,144,2,14,358
264552,664,29,144,13,118,968
264554,236,49,139,7,67,498
264556,207,9,144,1,95,456
264557,461,1,0,5,17,484
264565,598,21,44,0,85,748
264566,67,9,0,7,56,139
264570,149,60,139,19,140,507
264571,584,18,0,19,157,778
264575,665,6,143,8,21,843
264577,609,9,0,25,95,738
264579,339,0,274,0,33,646
264580,468,3,143,0,33,647
264582,488,0,0,0,12,500
264585,434,1,139,0,12,586
264586,168,3,0,1,5,177
264587,521,5,0,10,103,639
264590,328,3,0,1,117,449
264592,411,0,0,0,166,577
264596,207,71,0,12,18,308
264597,407,2,0,10,36,455
264598,366,16,143,6,37,568
264600,468,0,0,8,199,675
264602,528,16,0,1,56,601
264603,175,2,0,11,2,190
264611,42,5,0,0,2,49
264619,306,173,276,24,28,807
264625,167,92,0,13,47,319
26463,0,0,0,0,0,0
264631,403,8,143,15,19,588
264634,165,90,0,10,41,306
26464,0,0,0,0,0,0
264641,162,43,0,5,91,301
264642,902,325,95,10,72,1404
264643,140,15,0,0,12,167
264651,164,68,108,5,33,378
264656,191,164,98,19,79,551
264657,612,154,229,0,50,1045
264658,0,0,0,0,0,0
264669,159,67,72,2,17,317
264673,153,50,144,0,11,358
264675,165,82,89,4,25,365
264679,262,125,262,11,16,676
264681,1166,434,336,63,262,2261
264685,171,76,124,14,50,435
264688,360,271,101,19,99,850
264689,169,116,144,22,39,490
264691,145,24,0,0,7,176
264692,122,70,144,14,5,355
264697,87,6,0,1,27,121
264701,161,93,0,13,62,329
264702,268,11,0,8,17,304
264704,167,111,144,24,46,492
264708,152,45,136,4,23,360
264712,164,84,83,9,18,358
264715,175,94,0,16,59,344
264716,165,100,144,13,12,434
26472,0,0,0,0,0,0
264723,167,121,0,8,35,331
264725,171,98,144,12,41,466
264726,121,92,0,12,4,229
264732,482,271,277,31,109,1170
264733,637,0,96,0,22,755
264736,1,1,0,0,0,2
264737,93,55,0,9,9,166
264739,186,95,0,13,28,322
264740,216,61,245,7,30,559
264741,283,118,0,5,24,430
264742,215,112,0,20,20,367
264743,173,90,144,24,38,469
264748,134,9,144,0,6,293
264752,162,114,144,18,20,458
264754,0,6,0,4,1,11
264756,374,12,144,0,8,538
264757,170,34,0,0,13,217
264758,431,206,0,11,43,691
264759,402,45,13,9,20,489
264760,101,27,0,0,6,134
264761,180,78,144,12,9,423
264765,340,215,144,33,81,813
264767,282,57,0,7,42,388
264768,241,71,0,8,27,347
264770,634,0,0,6,9,649
264771,300,130,141,17,67,655
264774,264,135,92,15,70,576
264776,122,75,0,11,44,252
264780,1450,416,22,53,480,2421
264781,166,90,34,17,56,363
264784,434,24,0,7,188,653
264786,147,35,0,4,45,231
264787,146,55,144,7,59,411
26479,0,0,0,0,0,0
264790,150,20,144,0,4,318
264791,67,7,0,0,1,75
264795,169,96,144,12,37,458
264797,871,304,195,33,56,1459
26480,196,0,0,0,6,202
264800,159,108,0,27,56,350
264806,165,64,144,10,63,446
264808,0,1,0,0,1,2
264809,225,52,144,4,13,438
264810,93,9,0,1,5,108
264814,295,91,100,26,104,616
264822,137,32,0,4,0,173
264827,201,61,84,14,29,389
264830,703,170,243,9,40,1165
264831,156,74,0,10,21,261
264832,170,80,0,13,11,274
264838,180,117,0,32,117,446
264849,149,15,0,5,14,183
264852,114,46,135,6,9,310
264856,666,346,352,26,120,1510
264857,251,90,144,0,23,508
264859,144,61,144,10,21,380
264861,434,0,144,7,193,778
264862,373,2,0,0,11,386
264863,298,5,0,11,22,336
264865,440,7,0,12,76,535
264866,228,11,0,10,100,349
264867,349,2,0,6,8,365
264868,422,6,0,15,136,579
264869,457,2,157,5,147,768
264870,287,2,0,0,12,301
264871,324,32,0,10,66,432
264872,244,18,0,14,38,314
264873,209,43,0,14,63,329
264876,466,2,144,11,36,659
264877,466,0,287,9,103,865
264880,833,11,288,16,105,1253
264881,1043,17,144,13,203,1420
264882,206,0,18,0,51,275
264884,320,22,0,21,148,511
264885,153,2,0,3,2,160
264886,617,43,0,14,181,855
264887,366,37,144,2,74,623
264888,364,6,0,5,94,469
264889,474,6,0,14,73,567
264890,36,0,0,0,61,97
264891,231,0,143,0,6,380
264893,112,1,0,1,54,168
264894,502,4,0,11,123,640
264896,409,0,0,2,38,449
264897,637,78,144,33,265,1157
264900,486,16,0,27,155,684
264901,419,1,0,2,30,452
264902,155,5,144,7,52,363
264903,383,6,144,0,82,615
264904,398,4,0,2,86,490
264906,678,57,0,3,151,889
264908,355,1,0,0,27,383
264909,902,16,287,13,263,1481
264910,312,2,288,3,4,609
264911,388,7,0,5,92,492
264912,439,16,0,10,99,564
264913,468,8,288,21,184,969
264916,12,0,0,1,0,13
264917,462,30,0,22,196,710
264919,109,9,0,0,7,125
264920,263,1,0,0,82,346
264921,447,1,0,1,91,540
264923,440,2,0,1,227,670
264925,315,25,0,10,18,368
264927,1209,30,143,43,349,1774
264929,478,5,0,2,120,605
264930,458,6,0,13,130,607
264931,113,2,0,3,123,241
264933,423,0,0,1,23,447
264934,282,3,0,2,175,462
264939,513,0,144,0,180,837
264940,406,4,0,2,78,490
264943,1349,3,431,5,18,1806
264944,556,10,0,20,337,923
264946,547,4,0,3,75,629
264947,434,0,0,5,63,502
264948,302,12,0,16,117,447
264950,144,2,0,1,121,268
264951,606,3,0,33,173,815
264952,912,79,0,23,263,1277
264953,499,2,0,1,102,604
264954,441,9,144,14,41,649
264955,563,19,144,0,167,893
264956,499,9,0,3,89,600
264959,282,89,0,38,150,559
26496,94,6,0,9,17,126
264961,348,9,0,4,71,432
264962,465,13,0,9,171,658
264963,285,16,0,7,61,369
264964,221,0,144,0,3,368
264965,190,1,0,1,1,193
264968,221,23,144,10,106,504
264970,202,0,0,4,6,212
264972,678,19,425,53,202,1377
264973,277,2,139,2,7,427
264975,387,4,0,9,23,423
264976,396,20,144,1,143,704
264978,465,0,4,0,25,494
264981,572,90,0,18,69,749
264982,276,44,4,13,106,443
264983,150,23,172,4,38,387
264986,105,0,137,0,0,242
264987,290,0,0,0,7,297
264988,419,2,0,0,100,521
264990,297,11,0,21,36,365
264992,250,2,0,0,28,280
265000,596,16,87,6,84,789
265001,475,4,0,3,38,520
265003,354,0,0,3,19,376
265004,383,14,16,9,38,460
265006,254,6,0,5,34,299
265007,142,1,0,0,10,153
265009,51,2,144,0,1,198
265013,169,1,0,0,4,174
265014,566,8,420,12,156,1162
265015,464,3,2,4,64,537
265016,327,11,30,20,40,428
265018,171,2,123,1,15,312
265019,440,11,0,16,83,550
265021,335,1,0,1,32,369
265022,266,115,144,46,138,709
265023,564,2,0,1,32,599
265025,273,3,287,2,40,605
265026,365,0,432,0,8,805
265027,94,12,0,4,41,151
265028,329,1,97,0,7,434
265029,414,3,144,9,41,611
265030,373,36,0,10,149,568
265032,451,2,137,4,61,655
265033,188,14,150,6,29,387
265036,538,8,0,12,184,742
265037,251,25,136,2,158,572
265040,340,9,0,1,153,503
265041,357,8,139,23,74,601
265043,404,7,423,9,100,943
265045,544,8,0,2,74,628
265048,619,21,0,8,78,726
265051,297,1,0,0,90,388
265054,585,3,0,9,96,693
265055,241,1,144,1,42,429
265056,409,3,144,7,205,768
265059,548,12,0,6,87,653
265060,475,6,0,20,116,617
265062,422,24,0,23,278,747
265065,644,15,144,18,189,1010
265066,521,128,2,33,150,834
265067,424,2,0,1,66,493
265070,370,1,0,15,34,420
265072,501,15,0,4,87,607
265074,243,50,192,27,89,601
265075,541,49,386,39,255,1270
265076,271,10,0,6,14,301
265078,422,3,0,11,56,492
265079,392,1,0,1,7,401
265081,487,16,0,19,161,683
265082,218,0,0,0,2,220
265083,279,0,0,0,7,286
265085,295,0,144,0,16,455
265086,392,53,0,7,125,577
265087,221,68,0,25,51,365
265089,550,7,0,2,140,699
265090,177,1,0,0,7,185
265091,249,2,0,2,47,300
265093,291,9,0,1,6,307
265094,323,12,143,10,132,620
265095,518,16,141,14,250,939
265097,511,2,0,0,33,546
265098,480,15,0,22,128,645
265099,85,2,0,0,1,88
265100,279,60,136,29,103,607
265102,527,2,141,0,3,673
265103,604,1,0,2,70,677
265104,378,1,2,4,12,397
265106,353,7,0,10,32,402
265107,170,1,0,0,61,232
265109,237,3,32,2,34,308
265111,379,29,0,15,168,591
265112,380,11,141,9,127,668
265113,589,2,2,25,211,829
265114,255,9,0,7,98,369
265116,258,56,0,16,94,424
265117,295,0,144,1,4,444
265118,644,19,285,7,220,1175
265121,609,4,0,10,145,768
265123,786,0,154,4,13,957
265124,281,3,0,9,108,401
265125,440,15,0,4,122,581
265126,866,8,154,22,233,1283
265127,197,29,0,8,39,273
265128,615,8,0,11,205,839
265129,173,1,0,1,10,185
265130,437,5,402,17,18,879
265131,0,0,0,0,0,0
265132,220,7,0,0,38,265
265134,207,0,200,0,86,493
265136,694,37,0,20,244,995
265137,237,1,0,1,7,246
265138,648,38,144,32,349,1211
265140,588,28,429,13,325,1383
265141,1575,1,278,3,141,1998
265142,108,0,0,4,18,130
265143,330,9,0,8,73,420
265144,572,65,144,41,327,1149
265148,544,3,0,0,51,598
265152,398,3,0,4,37,442
265153,404,1,0,0,18,423
265154,570,21,0,16,211,818
265155,352,16,0,16,91,475
265157,119,10,0,1,28,158
265164,196,0,0,4,46,246
265166,517,3,284,1,68,873
265171,749,27,103,20,26,925
265172,668,35,287,28,417,1435
265173,162,1,141,6,14,324
265176,219,10,143,2,31,405
265177,82,1,259,0,1,343
265178,348,1,0,3,14,366
265181,373,100,0,27,145,645
265185,257,6,0,6,4,273
265186,185,28,143,8,66,430
265187,319,0,100,0,62,481
265188,486,34,143,39,249,951
265189,977,1,431,0,30,1439
265191,203,9,0,1,68,281
265198,644,13,143,21,77,898
265200,192,0,271,0,4,467
265205,203,19,143,10,102,477
265207,596,7,287,6,103,999
265209,300,8,144,5,7,464
265211,603,0,0,0,26,629
265213,439,7,11,15,70,542
265215,238,10,0,5,129,382
265220,582,8,0,22,109,721
265221,146,3,0,2,31,182
265223,580,14,144,1,26,765
265224,529,0,0,0,55,584
265227,390,0,0,0,93,483
26523,65,0,0,0,2,67
265230,212,1,0,9,50,272
265231,492,1,144,0,18,655
265233,1300,1,143,1,93,1538
265234,912,9,132,15,136,1204
265237,635,9,0,39,167,850
265239,879,3,0,4,95,981
265241,997,15,144,3,107,1266
265243,45,1,0,1,7,54
265244,157,19,0,0,22,198
265246,288,0,0,0,1,289
265247,723,4,376,6,53,1162
265250,345,2,0,2,32,381
265256,136,32,0,25,43,236
265259,492,3,0,8,114,617
265260,442,11,144,9,196,802
265265,365,2,270,0,22,659
265266,88,0,144,0,127,359
265267,615,8,144,18,338,1123
265271,396,28,0,34,186,644
265275,601,2,0,8,72,683
265278,31,25,0,34,74,164
265279,775,2,0,2,64,843
265281,416,1,288,1,80,786
265286,232,25,144,13,77,491
265287,158,3,144,0,26,331
265288,461,18,0,16,201,696
265289,271,20,144,1,61,497
265291,406,23,0,19,102,550
265293,367,5,24,3,4,403
265295,429,1,0,3,41,474
265296,427,14,0,17,130,588
265298,452,3,168,3,48,674
265299,638,64,288,5,233,1228
265301,395,45,144,22,99,705
265302,444,22,0,19,139,624
265303,1394,23,286,26,61,1790
265304,186,1,145,0,2,334
265305,102,1,76,3,8,190
265308,321,30,144,7,69,571
265314,64,12,0,4,93,173
265315,390,79,144,26,140,779
265317,407,29,144,23,112,715
265318,535,8,144,13,87,787
265319,287,79,0,6,116,488
265321,501,1,0,7,65,574
265324,510,2,111,1,11,635
265327,407,0,0,0,33,440
265328,182,5,93,0,2,282
265330,80,6,0,7,15,108
265336,424,9,0,1,11,445
265338,376,17,144,0,22,559
265339,389,8,144,11,138,690
265341,550,15,0,17,132,714
265343,336,5,0,0,43,384
265345,420,4,144,1,25,594
265349,169,9,0,1,5,184
265350,585,1,0,0,27,613
265354,543,21,396,24,209,1193
265355,77,17,28,0,2,124
265356,375,18,144,1,54,592
265357,360,9,131,9,99,608
265358,150,14,0,3,31,198
265359,378,9,0,12,166,565
265361,514,1,172,1,28,716
265364,447,40,144,12,158,801
265367,186,0,0,0,2,188
265369,314,28,156,30,77,605
265370,447,7,144,12,150,760
265371,271,0,0,1,9,281
265378,192,5,0,4,40,241
265381,316,3,143,0,22,484
265382,372,1,144,1,31,549
265388,419,4,428,2,47,900
265393,298,56,0,44,125,523
265394,421,2,0,2,43,468
265395,411,23,196,30,198,858
265396,281,0,0,4,31,316
265398,484,2,0,9,72,567
265401,481,4,0,0,37,522
265403,164,7,111,0,23,305
265405,437,0,0,2,43,482
265407,494,20,0,1,126,641
265409,531,17,141,4,16,709
265410,444,1,288,17,44,794
265411,566,5,282,12,180,1045
265412,290,6,0,4,40,340
265413,214,0,0,1,5,220
265414,64,11,0,22,77,174
265415,215,0,0,1,99,315
265417,362,13,139,8,105,627
265419,128,4,0,1,2,135
265420,611,15,0,4,120,750
265424,429,1,141,5,22,598
265427,505,8,139,1,87,740
265428,454,2,277,2,52,787
265429,257,41,141,14,60,513
265430,412,13,286,7,63,781
265432,339,15,255,9,43,661
265434,200,47,0,24,52,323
265436,86,23,0,14,128,251
265437,92,11,144,0,13,260
265439,227,4,0,0,26,257
265440,522,8,0,11,156,697
265441,212,1,0,0,10,223
265443,49,0,0,0,0,49
265445,433,17,0,12,21,483
265446,3,0,0,0,1,4
265448,269,11,0,13,144,437
265452,40,1,0,0,0,41
265453,44,2,0,1,2,49
265455,337,1,0,0,5,343
265459,441,16,0,12,223,692
26546,690,3,4,1,132,830
265460,509,9,0,7,73,598
265461,387,66,0,22,242,717
265464,397,5,144,7,8,561
265465,663,20,144,11,140,978
265466,209,2,0,4,19,234
265467,198,13,0,6,47,264
265468,500,33,0,25,150,708
265472,317,6,0,0,21,344
265473,418,2,0,1,7,428
265475,397,22,144,30,214,807
265476,433,0,144,0,144,721
265477,339,37,141,24,186,727
265481,338,1,146,6,60,551
265482,566,7,0,19,135,727
265483,186,39,0,18,74,317
265485,493,15,0,13,182,703
265488,73,0,0,0,13,86
265489,672,76,144,17,244,1153
265491,457,10,288,7,140,902
265495,118,53,0,0,13,184
265496,434,10,0,9,92,545
265497,163,1,0,1,3,168
265498,282,1,0,0,2,285
265499,472,36,0,26,118,652
26554,0,0,0,0,0,0
265554,26,15,13,0,1,55
26557,0,0,0,0,0,0
265573,0,0,0,0,0,0
265577,261,2,56,4,50,373
265585,0,0,0,0,0,0
265594,0,0,0,0,0,0
265626,137,4,10,7,69,227
265627,0,0,0,0,0,0
265630,324,179,139,36,106,784
265634,153,21,0,0,8,182
265637,66,46,0,10,6,128
265638,151,67,143,5,16,382
265639,165,95,141,10,38,449
265642,825,137,15,20,61,1058
265643,1,5,0,1,0,7
265646,156,58,0,7,27,248
265648,117,65,0,5,1,188
265653,31,18,0,0,1,50
265659,149,55,144,5,21,374
265661,304,15,144,1,60,524
265662,139,85,95,11,46,376
265663,367,43,0,10,20,440
265673,163,64,144,13,18,402
265674,145,45,0,8,17,215
265675,230,105,144,22,89,590
265676,154,90,144,14,23,425
265679,3,4,16,0,2,25
265683,18,32,0,10,17,77
265686,162,109,144,21,43,479
265689,178,2,0,3,50,233
265692,11,4,0,0,1,16
265697,166,69,79,9,8,331
265699,162,93,36,10,24,325
265701,1,0,144,0,0,145
265703,340,136,231,25,92,824
265704,229,125,144,4,18,520
265705,41,16,26,9,1,93
265707,200,99,131,11,29,470
265708,163,85,0,6,40,294
265710,125,86,78,7,12,308
265713,187,64,0,14,19,284
265714,323,118,42,24,149,656
265719,62,34,0,0,8,104
265720,138,7,2,3,7,157
265722,149,86,0,6,15,256
265725,144,67,144,1,9,365
265729,170,50,0,4,15,239
265736,140,79,144,10,29,402
265737,1,1,0,3,1,6
265738,102,47,0,3,2,154
265739,85,13,0,4,5,107
265740,123,70,0,2,22,217
265741,238,189,115,18,65,625
265743,166,53,0,8,60,287
265744,158,65,0,4,22,249
265746,170,48,0,8,7,233
265748,172,108,0,12,41,333
265749,117,94,0,12,16,239
265750,120,57,2,7,8,194
265751,97,46,0,3,3,149
265754,127,40,144,4,12,327
265757,179,91,86,12,105,473
265758,103,29,0,12,13,157
265760,122,30,100,0,3,255
265763,98,2,141,0,3,244
265768,238,157,116,19,18,548
265771,164,88,144,14,24,434
265772,218,121,0,17,67,423
265773,151,40,144,1,9,345
265774,42,15,144,0,2,203
265776,316,176,2,23,43,560
265777,146,46,0,3,8,203
265782,2,20,144,7,2,175
265783,41,62,0,12,42,157
265790,62,2,144,0,0,208
265791,113,15,143,0,7,278
265792,142,17,144,0,3,306
265793,170,11,0,0,0,181
265795,177,96,144,10,34,461
265798,246,139,144,42,56,627
265801,33,11,0,0,1,45
265802,107,7,144,1,7,266
265804,310,123,15,7,16,471
265805,173,59,144,1,8,385
265808,170,68,0,0,19,257
265810,131,24,87,6,5,253
265813,135,33,144,3,14,329
265816,1429,685,464,97,176,2851
265817,313,119,0,4,67,503
265823,165,101,144,10,46,466
265824,163,85,0,17,21,286
265828,526,47,0,16,108,697
265830,148,46,0,5,15,214
265835,222,72,0,9,16,319
265841,131,2,0,0,6,139
265842,174,58,0,2,19,253
265843,197,115,144,20,21,497
265848,165,87,0,13,27,292
265851,151,55,0,5,25,236
265852,174,112,0,21,46,353
265853,16,13,0,9,28,66
265854,116,161,0,0,8,285
265856,173,83,138,9,13,416
265857,83,33,0,2,1,119
265858,149,27,0,2,27,205
265860,2,2,0,0,1,5
265862,423,132,0,35,85,675
265865,180,47,42,11,12,292
265866,152,51,0,6,28,237
265868,212,54,0,8,15,289
265872,139,62,0,0,12,213
265876,171,88,144,18,31,452
265877,502,130,144,13,115,904
265879,34,51,0,6,28,119
265883,429,2,0,2,43,476
265885,459,0,0,0,5,464
265886,313,15,0,4,91,423
265887,282,2,0,2,8,294
265888,465,13,0,6,137,621
265889,638,1,0,1,12,652
265893,351,5,285,7,98,746
265898,574,1,0,5,53,633
265899,536,2,426,1,127,1092
265903,145,3,0,2,44,194
265905,188,83,0,12,116,399
265906,237,1,0,5,8,251
265907,171,8,141,17,22,359
265911,1522,57,499,50,438,2566
265914,328,6,141,6,129,610
265915,495,1,4,0,12,512
265917,198,12,0,4,38,252
265918,437,17,144,22,118,738
26592,384,26,288,6,11,715
265920,462,3,0,8,57,530
265923,135,0,2,0,2,139
265924,216,3,0,7,5,231
265927,269,19,0,8,31,327
265928,436,5,6,1,5,453
265930,208,14,198,3,33,456
265933,550,21,0,25,187,783
265934,251,2,0,2,52,307
265937,488,5,287,10,145,935
265938,482,20,0,18,250,770
265942,509,3,73,4,42,631
265943,424,43,139,16,108,730
265944,138,10,141,3,18,310
265945,367,22,0,16,229,634
265947,389,2,135,1,51,578
265948,455,7,286,8,111,867
265949,393,2,0,4,57,456
265952,414,2,143,1,26,586
265954,373,2,287,1,46,709
265955,296,0,0,6,121,423
265956,616,29,287,28,226,1186
265958,311,2,0,13,54,380
265960,304,8,143,8,170,633
265961,331,2,136,4,154,627
265962,469,10,143,18,216,856
265964,384,6,146,0,60,596
265965,279,1,269,0,48,597
265969,221,75,144,1,125,566
265970,312,6,0,6,83,407
265971,362,1,0,1,103,467
265972,447,36,0,39,257,779
265973,381,3,0,13,23,420
265974,530,15,0,22,148,715
265978,141,1,143,10,55,350
265980,237,20,141,14,107,519
265982,114,0,0,0,47,161
265984,134,42,0,5,27,208
265985,651,23,285,9,297,1265
265986,1,0,0,0,0,1
265989,479,3,0,4,166,652
26599,68785,1466,2831,478,18621,92181
265990,447,18,144,4,84,697
265992,436,1,0,0,229,666
265995,520,6,0,6,95,627
265997,375,8,141,5,79,608
265998,396,3,144,1,111,655
265999,44,0,123,0,2,169
266003,383,19,0,7,46,455
266005,569,6,0,4,113,692
266011,0,3,143,0,0,146
266013,301,14,0,7,63,385
266014,93,0,0,0,1,94
266015,327,84,144,29,99,683
266016,549,3,145,3,102,802
266017,34,0,141,0,1,176
266019,647,8,0,9,253,917
266020,180,17,0,7,51,255
266021,146,28,8,7,4,193
266022,65,2,143,2,0,212
266025,56,0,2,1,1,60
266029,349,1,0,0,16,366
266031,26,0,0,0,1,27
266032,426,13,0,11,72,522
266034,459,9,6,1,29,504
266035,483,1,144,0,4,632
266037,482,4,0,1,82,569
266040,613,41,285,33,119,1091
266042,355,16,284,12,96,763
266043,528,1,141,5,17,692
266044,583,41,144,23,188,979
266045,109,1,0,0,1,111
266046,508,4,0,2,66,580
266047,270,2,0,1,61,334
266050,536,228,571,54,83,1472
266051,143,0,0,0,1,144
266052,460,1,90,0,18,569
266053,270,1,0,0,2,273
266054,341,12,0,16,171,540
266055,181,19,0,0,28,228
266057,392,7,139,5,71,614
266058,665,4,0,8,109,786
266059,232,0,144,1,12,389
26606,20,0,0,4,0,24
266060,470,13,141,12,144,780
266061,546,2,77,25,33,683
266062,459,12,2,9,169,651
266063,369,3,0,8,48,428
266067,384,1,48,5,62,500
266070,446,93,144,17,157,857
266071,197,1,0,7,31,236
266074,477,4,146,9,91,727
266080,311,11,136,9,90,557
266081,466,15,251,14,197,943
266083,396,1,282,0,30,709
266089,188,5,139,1,23,356
26609,1345,70,0,32,67,1514
266090,440,10,379,3,34,866
266091,16,9,144,1,15,185
266094,167,4,144,3,9,327
266100,269,11,0,13,189,482
266102,447,9,0,4,87,547
266105,440,3,0,1,56,500
266107,555,9,149,9,185,907
266111,0,0,144,0,19,163
266112,530,4,0,20,95,649
266113,428,2,141,1,111,683
266114,406,0,0,1,33,440
266115,109,1,0,1,13,124
266116,352,6,0,13,4,375
266118,601,0,144,0,397,1142
266119,349,0,141,1,36,527
266120,314,1,144,1,13,473
266121,113,4,0,1,56,174
266123,423,1,0,25,153,602
266124,334,0,0,4,53,391
266126,173,15,141,8,50,387
266127,424,5,0,7,71,507
266128,208,5,249,8,111,581
266130,941,4,144,1,106,1196
266133,216,0,0,0,177,393
266135,313,2,64,1,50,430
266137,536,7,248,19,105,915
266140,408,1,144,13,32,598
266141,267,13,143,19,184,626
266142,420,22,284,2,118,846
266143,656,1,0,6,31,694
266144,237,5,143,14,74,473
266145,206,0,0,0,8,214
266146,423,9,276,19,184,911
266149,329,67,158,0,10,564
26615,46355,1953,3671,498,6592,59069
266150,493,7,145,14,278,937
266154,476,12,139,10,134,771
266160,1157,34,145,35,282,1653
266162,176,22,0,5,47,250
266163,350,0,143,0,13,506
266164,130,0,0,5,3,138
266165,156,0,0,0,4,160
266166,450,3,144,1,80,678
266167,335,5,287,5,159,791
266168,221,3,144,2,14,384
266170,302,6,0,2,253,563
266171,194,61,66,8,72,401
266175,412,2,288,0,118,820
266176,100,1,196,0,13,310
266177,357,7,6,20,119,509
266179,32,1,0,0,1,34
266181,1127,462,0,98,538,2225
266183,411,13,41,10,185,660
266184,522,32,144,8,180,886
266185,404,0,144,0,155,703
266186,343,10,144,3,93,593
266191,619,16,0,12,117,764
266192,326,25,141,7,171,670
266193,572,4,2,16,146,740
266196,97,16,0,14,43,170
266198,159,5,193,13,32,402
266200,482,9,123,13,253,880
266201,200,12,0,11,104,327
266202,437,25,0,1,230,693
266203,455,2,287,2,22,768
266204,108,14,286,9,17,434
266205,480,6,139,0,62,687
266206,264,4,287,3,94,652
266207,371,13,284,10,150,828
266209,247,1,144,1,6,399
26621,273,101,0,5,20,399
266210,385,2,19,1,16,423
266211,543,9,141,19,94,806
266213,529,26,288,6,190,1039
266216,461,22,139,27,183,832
266217,43,1,286,0,1,331
266219,391,1,288,1,22,703
266220,0,0,0,0,0,0
266223,389,9,280,8,76,762
266224,476,26,147,14,216,879
266227,322,2,23,0,71,418
266231,458,1,89,0,42,590
266232,394,10,285,28,185,902
266235,159,31,0,11,35,236
266236,368,9,143,12,116,648
266238,494,0,143,7,28,672
266242,173,5,0,1,52,231
266244,326,2,2,1,44,375
266245,108,0,144,0,2,254
266248,427,3,0,4,85,519
266250,398,4,0,14,123,539
266251,252,0,0,1,68,321
266252,370,0,144,0,13,527
266253,487,1,141,6,61,696
266254,609,18,144,11,127,909
266256,274,3,0,4,52,333
266258,253,0,2,6,2,263
266263,399,11,144,11,158,723
266265,441,8,285,12,180,926
266266,322,1,0,0,8,331
266270,59,1,286,6,6,358
266272,325,16,0,10,97,448
266274,472,38,0,14,187,711
266275,182,19,77,4,66,348
266276,18,0,31,0,1,50
266277,286,28,0,4,66,384
266279,171,24,0,14,23,232
266280,415,1,288,0,13,717
266281,409,13,144,2,23,591
266287,605,11,0,28,80,724
266290,105,0,0,0,1,106
266292,147,0,0,0,2,149
266295,138,2,0,1,12,153
266296,225,3,0,0,10,238
266298,203,26,144,11,51,435
266299,339,9,0,10,106,464
266300,446,1,0,0,3,450
266301,468,0,0,1,48,517
266303,270,1,144,0,10,425
266305,653,29,143,7,212,1044
266308,474,19,0,24,210,727
266311,455,23,0,25,119,622
266313,318,2,0,7,38,365
266314,178,1,0,0,117,296
266315,159,8,0,2,8,177
266319,290,77,0,28,133,528
266321,214,1,0,0,3,218
266326,557,3,0,1,51,612
266327,424,1,144,9,100,678
266328,571,2,144,1,84,802
266329,148,0,144,0,1,293
266330,210,38,144,17,35,444
266331,237,1,0,0,3,241
266332,188,23,0,12,37,260
266333,315,0,0,4,4,323
266334,370,36,288,0,38,732
266335,24,0,0,6,9,39
266338,443,1,0,4,41,489
266341,91,2,0,4,25,122
266343,376,5,0,14,115,510
266344,444,21,0,29,280,774
266345,248,20,0,10,54,332
266346,460,1,0,3,41,505
266350,495,7,144,5,184,835
266351,305,7,0,8,116,436
266354,486,3,144,2,51,686
266355,644,29,0,24,315,1012
266356,445,8,0,11,129,593
266357,541,7,144,6,125,823
26636,1451,15,0,32,725,2223
266360,229,2,0,14,36,281
266366,388,13,144,13,160,718
266367,159,3,288,4,3,457
266368,418,10,0,4,113,545
266370,348,1,0,4,26,379
266371,553,5,0,17,93,668
266372,97,59,144,0,0,300
266375,416,27,0,11,156,610
266380,111,1,0,7,61,180
266381,444,9,39,4,58,554
266382,490,2,0,3,66,561
266383,289,5,0,1,21,316
266384,158,14,144,13,44,373
266385,130,4,288,11,55,488
266386,566,2,0,7,77,652
266387,739,1,0,4,40,784
266389,607,14,0,20,163,804
266391,168,3,0,0,28,199
266393,498,8,0,7,140,653
266395,1196,30,287,21,449,1983
266398,247,16,0,4,71,338
266399,44,0,0,0,6,50
266401,589,6,0,6,128,729
266402,188,63,144,28,72,495
266403,413,12,144,9,140,718
266404,253,0,0,1,26,280
266405,36,2,0,1,8,47
266406,45,0,0,0,1,46
266408,362,0,144,3,47,556
266409,224,17,0,20,97,358
266413,583,59,0,9,51,702
266414,1075,84,572,74,621,2426
266416,73,9,0,7,40,129
266418,246,30,0,12,64,352
266419,271,1,0,7,184,463
266420,550,8,0,3,139,700
266421,475,5,144,1,79,704
266423,352,2,0,9,83,446
266425,443,0,0,1,83,527
266427,439,12,0,3,151,605
266428,296,33,144,35,195,703
266429,316,16,0,14,117,463
266433,369,1,144,2,36,552
266434,495,2,0,2,92,591
266435,707,11,0,27,94,839
266436,205,1,144,16,13,379
266438,383,15,0,10,110,518
266439,349,1,143,0,11,504
266447,338,13,0,21,148,520
266448,643,5,0,16,121,785
266449,583,7,0,9,170,769
266451,452,2,0,7,43,504
266452,242,0,0,8,11,261
266453,496,23,0,33,212,764
266454,496,23,287,29,290,1125
266457,341,23,0,18,182,564
266459,129,1,0,0,12,142
266462,404,10,0,4,97,515
266466,619,18,0,33,172,842
266467,560,1,0,8,79,648
266468,415,12,144,12,75,658
266470,583,3,143,5,140,874
266471,334,4,0,14,152,504
266473,111,38,144,17,39,349
266477,577,22,144,16,209,968
266478,105,6,0,4,20,135
266479,417,6,0,14,118,555
266481,306,1,144,0,21,472
266482,342,2,0,0,23,367
266483,228,1,0,0,21,250
266487,330,1,0,4,44,379
266488,320,1,144,0,3,468
266489,614,15,0,9,115,753
266491,273,1,0,0,13,287
266492,391,23,0,13,166,593
266498,667,46,431,15,75,1234
266499,696,18,0,18,173,905
2665,111,0,0,0,0,111
266500,449,39,0,20,174,682
266503,268,6,144,14,88,520
266504,418,12,0,12,104,546
266507,357,1,0,1,21,380
266508,348,14,0,8,33,403
266509,174,9,0,1,44,228
266510,442,2,144,4,44,636
266513,455,9,0,7,140,611
266519,259,5,2,16,35,317
26652,0,0,0,0,0,0
266522,185,5,0,0,5,195
266523,227,13,144,16,50,450
266524,634,48,288,15,307,1292
266525,394,3,0,12,92,501
266526,457,0,141,6,5,609
266528,469,27,141,9,39,685
266529,519,4,143,11,72,749
266530,539,8,143,17,104,811
266531,335,1,0,0,2,338
266532,624,52,144,46,82,948
266533,213,3,0,7,91,314
266534,440,23,0,15,78,556
266536,446,2,0,1,48,497
266537,461,31,144,4,90,730
266538,146,0,254,7,2,409
266539,626,60,0,32,172,890
266541,197,0,0,0,5,202
266542,16,1,0,0,0,17
266543,502,18,2,8,98,628
266544,425,4,0,1,43,473
266545,448,1,141,0,30,620
266546,425,1,0,0,104,530
266547,278,3,0,3,89,373
266549,434,21,144,6,156,761
266550,174,1,0,0,30,205
266551,547,18,144,17,199,925
266552,520,1,0,1,28,550
266553,163,43,0,15,32,253
266554,253,2,0,1,23,279
266555,1073,30,0,57,591,1751
266556,478,10,144,10,114,756
266558,271,1,0,4,22,298
266559,8,0,0,1,0,9
266560,336,0,144,0,162,642
266562,343,0,141,7,8,499
266563,378,5,0,5,102,490
266564,193,11,0,4,31,239
266565,268,1,0,0,5,274
266567,493,10,427,32,101,1063
266569,23,0,0,0,0,23
266570,1,0,0,0,0,1
266574,268,0,0,1,3,272
266575,111,2,288,1,12,414
266577,331,0,0,0,4,335
266583,200,0,0,0,0,200
266586,419,1,215,0,233,868
266587,412,0,0,1,118,531
266590,535,14,144,9,197,899
266592,110,24,0,29,60,223
266593,310,25,144,14,140,633
266595,318,4,144,12,62,540
266596,621,15,285,23,259,1203
266597,0,0,0,0,0,0
266598,417,0,141,0,5,563
266599,470,3,143,8,119,743
266601,316,3,141,1,43,504
266603,746,9,144,7,133,1039
266605,364,0,144,6,188,702
266608,160,42,0,6,58,266
266611,388,18,0,11,72,489
266613,281,3,285,3,189,761
266615,390,10,288,2,49,739
266617,364,13,0,11,142,530
266618,203,2,0,19,46,270
266622,500,9,2,10,185,706
266624,868,81,0,33,344,1326
266626,184,9,0,3,48,244
266628,436,2,0,1,181,620
266631,582,12,0,15,139,748
266632,667,15,0,6,115,803
266633,525,1,0,0,191,717
266634,444,6,144,12,157,763
266636,459,10,0,13,73,555
266638,355,1,141,1,21,519
266640,445,20,0,11,199,675
266641,319,0,0,1,31,351
266644,103,12,0,0,0,115
266646,202,23,0,9,40,274
266647,424,8,0,14,19,465
266651,285,67,0,25,56,433
266652,471,4,0,5,177,657
266653,171,89,0,8,42,310
266656,174,6,0,0,5,185
266668,444,111,0,31,208,794
266673,261,74,143,33,203,714
266674,154,52,0,0,4,210
266675,119,20,0,1,12,152
266677,414,2,55,0,13,484
266682,152,52,0,7,7,218
266683,277,3,0,0,12,292
266685,374,32,143,9,101,659
266687,87,118,0,6,15,226
266690,136,18,144,7,11,316
266694,264,9,0,6,12,291
266702,159,81,134,14,35,423
266703,167,81,4,6,25,283
266704,334,165,0,27,87,613
266705,234,79,0,17,29,359
266706,104,46,144,5,13,312
266707,156,85,0,11,31,283
266710,122,56,143,29,18,368
266713,129,35,0,3,42,209
266721,323,112,0,17,46,498
266725,269,219,144,36,99,767
266731,165,65,0,12,72,314
266735,13,66,118,6,4,207
266740,228,96,0,2,46,372
266741,154,18,0,0,8,180
266743,353,144,144,17,91,749
266749,481,266,287,24,75,1133
266752,261,35,144,24,5,469
266753,169,85,0,12,38,304
266754,200,81,0,3,25,309
266758,148,40,102,7,12,309
266760,32,2,144,0,3,181
266761,166,82,0,3,24,275
266763,3,24,0,1,2,30
266764,159,79,0,13,5,256
266765,163,32,0,12,34,241
266769,281,143,0,15,55,494
266771,154,71,0,13,34,272
266772,256,117,0,18,43,434
266776,18,0,0,0,0,18
266777,100,48,0,11,6,165
266779,171,74,144,13,76,478
266781,77,17,122,0,2,218
266782,242,1,0,0,7,250
266784,226,1,0,1,27,255
266785,153,63,144,7,11,378
266786,129,50,0,4,15,198
266788,107,65,0,7,8,187
266791,164,107,144,16,34,465
266794,137,49,82,2,8,278
266801,20,12,0,3,1,36
266805,556,11,0,20,175,762
266806,277,136,144,35,57,649
266807,98,39,144,8,5,294
266814,363,2,0,3,23,391
266815,0,0,0,0,0,0
266818,84,2,2,4,5,97
266825,141,63,0,6,20,230
266829,204,103,0,13,39,359
266830,144,109,0,10,61,324
266831,495,14,0,13,36,558
266836,167,97,0,15,33,312
266837,74,17,0,3,2,96
266838,178,38,0,18,22,256
266843,314,165,0,11,71,561
266844,90,2,101,1,9,203
266845,146,44,0,8,12,210
266847,158,67,0,10,68,303
266850,148,69,102,11,21,351
266852,48,40,0,7,22,117
266854,163,102,107,14,49,435
266857,217,82,0,10,51,360
266858,235,3,232,0,10,480
266861,131,56,0,8,17,212
266866,226,44,0,8,27,305
266870,149,88,144,33,92,506
266872,306,0,0,1,5,312
266873,123,61,11,0,13,208
266874,138,44,128,3,6,319
266878,117,61,0,9,23,210
266883,117,47,0,3,10,177
266884,118,5,0,2,4,129
266885,173,113,0,13,50,349
266887,175,56,0,8,69,308
266890,92,34,0,5,10,141
266891,166,72,0,4,41,283
266898,173,103,0,4,32,312
266905,44,9,0,3,1,57
266910,218,44,0,4,32,298
266914,481,20,0,21,82,604
266915,199,47,0,18,83,347
266916,244,1,0,1,13,259
266917,517,0,0,1,154,672
266919,294,4,0,4,32,334
266922,319,3,0,2,34,358
266923,482,29,0,21,202,734
266924,512,6,0,4,96,618
266931,461,2,125,5,297,890
266932,199,1,0,11,35,246
266933,447,6,0,8,98,559
266936,482,1,0,4,25,512
266937,205,34,144,11,31,425
266938,320,14,0,8,49,391
266939,357,1,0,4,70,432
266940,399,2,0,0,36,437
266942,649,37,0,17,176,879
266944,168,0,0,6,9,183
266945,561,3,0,0,28,592
266947,730,10,0,7,177,924
266948,444,26,0,23,217,710
266949,224,9,0,8,74,315
266950,598,10,0,23,194,825
266951,560,16,0,15,244,835
266952,85,35,0,0,0,120
266953,398,28,0,19,221,666
266954,388,2,287,10,9,696
266955,529,12,0,12,69,622
266956,369,1,0,1,27,398
266957,394,2,0,16,33,445
266958,313,24,278,7,101,723
266959,94,2,0,2,108,206
266961,654,3,303,7,140,1107
266962,390,16,0,10,147,563
266966,132,2,0,0,2,136
266967,139,0,0,4,59,202
266968,441,4,0,14,95,554
266969,316,5,0,1,3,325
266972,263,5,0,3,9,280
266974,479,2,0,0,29,510
266976,69,0,0,0,1,70
266977,372,10,0,5,65,452
266978,253,48,0,24,77,402
266984,135,5,68,8,70,286
266985,93,23,85,0,51,252
266986,410,1,141,2,28,582
266987,104,0,141,0,4,249
266988,118,0,0,0,0,118
266989,1410,39,144,38,575,2206
266990,215,2,143,0,13,373
266992,253,0,141,3,4,401
266993,191,25,287,10,58,571
266995,337,9,0,10,142,498
266996,648,1,0,2,86,737
266998,200,2,0,0,11,213
266999,578,31,0,14,78,701
267004,556,10,0,29,169,764
267005,348,0,0,0,39,387
267006,522,14,285,9,86,916
267007,107,41,0,14,13,175
267008,340,2,0,0,15,357
267011,623,17,0,17,198,855
267012,175,47,141,16,43,422
267014,300,0,0,0,4,304
267015,224,2,215,1,75,517
267016,459,1,0,7,42,509
267018,609,7,0,12,165,793
267020,484,7,144,7,73,715
267022,474,5,0,10,58,547
267024,325,9,0,17,135,486
267025,374,1,143,3,42,563
267026,42,7,0,0,3,52
267027,114,49,0,7,24,194
267028,474,2,0,1,30,507
267029,552,34,143,42,307,1078
267030,297,0,0,0,19,316
267032,542,69,0,42,313,966
267033,298,1,0,3,6,308
267034,540,1,0,2,12,555
267037,252,29,0,6,45,332
267038,577,50,0,25,348,1000
267040,146,19,0,6,13,184
267043,285,2,0,8,25,320
267045,490,2,0,10,47,549
267046,315,5,0,0,28,348
267047,344,2,0,6,39,391
267050,385,2,143,4,61,595
267052,378,0,0,1,32,411
267054,593,3,143,10,130,879
267055,495,6,0,6,95,602
267057,296,8,287,0,22,613
267058,265,50,150,24,86,575
267059,273,20,0,19,117,429
267061,496,0,135,0,3,634
267062,197,45,144,7,64,457
267063,372,0,0,4,31,407
267065,542,4,0,3,48,597
267069,313,1,0,0,6,320
267070,568,9,0,21,81,679
267072,87,1,0,2,7,97
267073,460,27,0,15,191,693
267074,363,34,0,17,181,595
267076,495,0,0,9,22,526
267077,529,1,0,0,37,567
267078,414,1,0,0,4,419
267081,438,10,145,24,131,748
267083,418,0,0,2,7,427
267085,246,6,144,1,17,414
267087,157,0,0,1,18,176
267088,421,3,0,3,8,435
267089,607,14,0,7,225,853
267091,342,1,0,0,17,360
267092,516,11,0,5,112,644
267097,224,7,0,9,11,251
267100,236,24,0,0,3,263
267101,486,24,287,12,113,922
267103,278,1,0,3,7,289
267104,468,3,0,2,51,524
267106,377,19,0,32,161,589
267107,277,1,0,3,23,304
267110,549,2,0,10,64,625
267113,451,18,0,25,161,655
267114,349,2,0,0,28,379
267117,498,24,143,10,202,877
267118,156,1,143,4,4,308
267119,480,3,0,10,39,532
267120,580,7,0,8,247,842
267121,148,2,0,1,2,153
267122,605,9,0,10,157,781
267123,310,2,0,5,36,353
267124,869,27,0,29,259,1184
267126,113,3,0,2,99,217
267128,23,2,0,0,1,26
267131,34,0,0,4,3,41
267132,523,28,0,20,200,771
267133,657,18,0,15,149,839
267134,194,13,0,12,57,276
267136,132,5,0,6,18,161
267137,337,1,0,0,3,341
267138,431,2,0,0,17,450
267139,434,2,0,7,188,631
267140,353,1,0,1,8,363
267144,440,80,0,14,144,678
267145,255,2,0,0,96,353
267146,467,21,144,15,184,831
267148,475,5,144,4,57,685
267149,331,24,143,2,12,512
267150,338,22,0,7,39,406
267151,371,0,0,1,20,392
267155,89,1,0,0,4,94
267156,118,11,0,15,77,221
267158,933,5,273,0,42,1253
267159,273,45,0,6,100,424
267164,504,9,144,14,137,808
267165,90,0,228,0,1,319
267166,329,0,147,0,3,479
267167,250,0,0,2,24,276
267168,397,0,286,1,25,709
267170,455,0,0,5,19,479
267171,638,16,10,28,195,887
267177,316,1,144,4,21,486
267178,513,1,418,4,51,987
267183,237,1,0,0,11,249
267185,387,2,0,1,35,425
267187,441,9,0,7,63,520
267188,439,11,144,27,157,778
267189,171,5,0,16,26,218
267190,772,4,287,3,229,1295
267192,201,3,98,4,26,332
267194,583,5,143,7,118,856
267195,452,39,143,20,273,927
267197,368,15,0,15,154,552
267199,545,1,141,4,34,725
267200,582,7,272,8,101,970
267201,529,86,123,57,291,1086
267202,427,3,0,4,27,461
267203,378,7,0,1,17,403
267205,174,14,0,16,113,317
267206,382,0,141,0,67,590
267208,739,5,0,18,130,892
267209,493,44,144,18,176,875
26721,1122,74,234,33,348,1811
267210,336,2,143,1,67,549
267211,257,43,284,12,60,656
267212,107,1,141,0,4,253
267214,242,89,286,18,75,710
267216,325,2,290,1,13,631
267217,216,0,123,0,3,342
267218,498,3,287,4,63,855
267219,319,9,181,1,8,518
267220,225,12,0,3,21,261
267221,443,2,0,6,112,563
267222,249,14,0,5,17,285
267223,425,15,284,17,103,844
267226,365,4,0,6,122,497
267227,294,3,141,13,108,559
267229,244,0,118,1,48,411
267232,422,0,141,7,27,597
267234,560,6,198,3,98,865
267235,336,1,145,0,1,483
267236,391,1,119,0,58,569
267237,170,34,24,4,43,275
267238,251,69,0,15,86,421
26724,8,0,0,0,0,8
267243,448,1,31,14,82,576
267245,107,3,135,0,8,253
267248,386,2,0,10,32,430
267249,451,1,0,7,18,477
26725,0,0,0,0,0,0
267250,349,14,0,1,66,430
267251,509,32,143,23,100,807
267252,526,5,0,2,30,563
267255,33,0,0,0,1,34
267256,156,2,0,4,13,175
267257,334,1,0,0,10,345
267261,401,18,4,19,180,622
267263,215,82,197,33,107,634
267264,475,5,0,9,63,552
267266,16,0,0,0,0,16
267267,409,27,0,6,85,527
267268,341,9,0,0,61,411
267269,229,5,144,4,99,481
26727,0,0,0,0,0,0
267270,210,7,0,7,35,259
267271,174,6,0,3,44,227
267276,426,32,143,30,182,813
267277,118,2,144,0,9,273
267279,513,17,143,15,157,845
267280,463,32,287,24,223,1029
267281,120,1,144,4,4,273
267283,184,3,0,2,1,190
267286,380,8,0,15,86,489
267288,122,4,0,3,30,159
267289,446,46,144,30,299,965
267291,489,17,0,23,237,766
267292,230,0,0,10,52,292
267293,258,51,0,26,79,414
267294,237,5,0,7,157,406
267295,211,1,143,0,146,501
267296,154,30,0,10,32,226
267297,443,23,428,16,173,1083
267298,102,8,0,0,34,144
267299,55,3,144,4,60,266
267301,328,0,0,1,11,340
267303,473,4,0,11,123,611
267307,566,7,143,19,212,947
267308,307,14,287,5,180,793
267311,486,12,284,6,95,883
267316,290,1,0,0,28,319
267318,448,26,0,27,192,693
267319,382,1,0,1,17,401
267320,424,19,0,5,26,474
267324,624,0,0,0,1,625
267325,345,15,143,11,100,614
267327,442,12,284,26,204,968
267328,219,0,0,3,3,225
267329,566,45,286,22,177,1096
267331,475,8,0,5,84,572
267334,181,18,0,4,53,256
267335,633,10,0,4,91,738
26734,0,0,0,0,0,0
267342,487,1,0,0,58,546
267344,397,3,0,10,28,438
267347,609,13,285,17,177,1101
267348,211,38,0,11,68,328
267350,611,2,0,21,183,817
267351,114,1,0,0,14,129
267353,296,0,0,0,126,422
267354,604,19,430,15,280,1348
267356,167,46,143,19,66,441
267357,810,6,0,8,98,922
267358,494,7,141,0,31,673
267360,494,3,0,5,141,643
267362,577,22,0,12,174,785
267363,260,20,0,5,113,398
267364,247,0,0,0,2,249
267365,271,2,0,12,63,348
267366,374,11,0,7,89,481
267369,414,6,0,2,24,446
267371,478,0,0,0,130,608
267373,217,58,143,51,99,568
267374,516,10,0,4,85,615
267376,456,18,0,2,66,542
267378,393,24,0,8,203,628
267379,402,0,0,7,116,525
267380,220,3,0,1,94,318
267382,242,11,0,21,105,379
267383,525,14,141,9,205,894
267384,579,10,144,0,314,1047
267385,81,56,0,9,0,146
267386,369,21,0,12,61,463
267388,470,1,0,0,66,537
267389,343,3,0,8,62,416
267391,390,2,0,3,48,443
267394,471,25,0,15,115,626
267395,414,15,0,12,102,543
267397,483,3,0,1,48,535
267398,596,63,0,45,377,1081
267399,422,1,0,1,31,455
267400,436,11,144,11,126,728
267401,550,7,0,14,170,741
267402,354,2,0,4,26,386
267403,401,2,0,4,104,511
267404,120,0,0,0,4,124
267406,6,0,0,0,0,6
267411,319,9,0,13,71,412
267412,274,5,0,14,185,478
267415,541,1,0,7,144,693
267416,118,28,0,11,24,181
267417,315,0,144,0,4,463
267418,214,6,143,1,51,415
267419,249,10,141,7,83,490
267421,588,9,411,10,157,1175
267422,375,0,0,0,10,385
267423,630,19,143,7,221,1020
267425,112,11,0,20,14,157
267428,278,42,0,19,186,525
267430,590,2,288,1,170,1051
267433,84,0,2,0,16,102
267436,289,6,0,0,19,314
267437,93,0,143,5,6,247
267439,115,0,0,2,3,120
26744,5,0,33,0,0,38
267442,1304,3,419,10,55,1791
267443,483,7,249,5,9,753
267446,248,6,141,7,11,413
267447,267,0,88,0,5,360
267448,288,2,58,0,7,355
267449,458,6,143,1,142,750
267450,628,25,144,27,418,1242
267452,1275,23,0,24,461,1783
267454,278,20,144,4,168,614
267457,343,0,0,0,20,363
267458,542,29,288,39,222,1120
267462,508,2,144,21,99,774
267463,706,247,281,49,388,1671
267466,222,50,266,34,101,673
267467,548,9,147,27,187,918
267469,271,0,144,0,39,454
267470,142,42,0,7,89,280
267471,477,8,144,4,84,717
267472,235,0,0,1,7,243
267473,214,1,0,7,60,282
267474,598,26,143,19,280,1066
267476,395,9,144,4,62,614
267477,540,2,0,0,30,572
267478,162,4,284,0,2,452
267479,139,9,0,1,40,189
267484,4019,34,286,30,632,5001
267488,392,5,141,3,41,582
267490,216,0,0,0,1,217
267491,221,6,144,4,28,403
267492,374,24,130,22,67,617
267493,238,1,0,0,2,241
267494,263,3,144,3,22,435
267495,469,3,286,5,100,863
267496,395,0,129,0,38,562
267497,582,3,117,1,43,746
267502,400,1,0,1,170,572
267503,317,79,417,35,118,966
267505,262,0,143,5,34,444
267508,569,0,284,0,18,871
267513,1483,110,285,50,597,2525
267516,399,8,144,10,88,649
267517,558,14,0,7,203,782
267518,288,10,0,22,144,464
267519,343,5,0,10,36,394
267520,181,11,0,4,5,201
267521,285,24,137,7,53,506
267522,434,1,182,4,56,677
267526,308,6,0,8,79,401
267528,354,2,0,0,6,362
267530,445,3,0,10,62,520
267531,404,15,0,7,62,488
267532,294,0,0,0,6,300
267536,412,1,0,8,119,540
267537,190,17,0,5,52,264
267539,121,3,0,3,19,146
267540,365,1,143,0,42,551
267543,305,0,0,0,21,326
267544,333,13,0,14,37,397
267546,354,1,0,1,19,375
267549,587,6,285,8,158,1044
267550,677,10,0,4,164,855
267552,454,14,0,15,94,577
267554,508,46,0,16,212,782
267555,401,2,0,7,58,468
267556,297,2,0,4,141,444
267557,577,3,0,1,166,747
267558,412,1,0,11,21,445
267560,221,22,141,11,89,484
267562,473,13,0,24,159,669
267563,563,1,0,2,9,575
267564,444,44,0,21,145,654
267565,92,6,0,1,4,103
267568,424,4,0,2,51,481
267570,404,0,0,1,95,500
267571,533,6,0,15,136,690
267572,518,4,0,7,83,612
267573,251,73,143,27,123,617
267574,337,0,0,8,46,391
267578,252,26,0,5,37,320
267581,541,4,0,8,72,625
267583,431,0,0,1,7,439
267584,135,4,0,0,4,143
267585,559,3,0,14,78,654
267589,408,9,0,11,90,518
267590,627,29,0,21,370,1047
267591,200,1,0,1,15,217
267593,432,8,0,22,112,574
267595,633,63,0,33,360,1089
26760,0,0,0,0,0,0
267600,296,1,0,0,27,324
267601,438,4,0,9,66,517
267603,575,22,0,24,260,881
267604,334,21,0,14,104,473
267606,434,17,0,4,73,528
267607,371,4,0,5,90,470
267608,788,22,144,28,336,1318
267612,416,1,0,1,10,428
267614,227,59,0,33,175,494
267616,201,0,0,1,12,214
267618,500,7,0,26,136,669
267620,509,28,0,13,188,738
267621,225,2,0,8,43,278
267624,1238,66,0,45,583,1932
267625,427,5,0,1,157,590
267626,240,0,0,0,105,345
267627,266,6,0,6,46,324
267629,142,47,0,23,94,306
267635,300,0,0,3,19,322
267637,465,6,0,21,71,563
267638,393,35,0,14,117,559
267639,243,9,0,3,127,382
267640,368,1,0,0,39,408
267642,62,1,0,0,19,82
267645,395,82,0,16,143,636
267646,231,35,0,5,46,317
267647,259,2,0,0,3,264
267648,242,2,0,0,3,247
267649,406,0,0,15,47,468
267651,406,2,0,5,76,489
267652,333,4,0,8,16,361
267653,244,0,0,6,1,251
267654,407,7,144,2,67,627
267659,178,5,0,9,9,201
267661,214,0,0,2,9,225
267662,375,1,0,0,2,378
267663,507,4,0,8,67,586
267665,401,21,0,7,63,492
267668,378,0,144,8,8,538
267671,427,5,0,8,33,473
267672,429,20,0,7,65,521
267673,319,8,0,10,31,368
267675,161,3,0,1,14,179
267676,563,3,0,8,84,658
267677,55,33,0,10,5,103
267679,136,34,0,11,49,230
267680,154,41,144,5,19,363
267686,148,85,0,4,39,276
267687,121,82,144,22,14,383
267688,131,54,0,10,11,206
267690,149,36,74,4,5,268
267694,116,32,0,0,6,154
267695,179,2,6,0,14,201
267697,255,61,0,6,51,373
267702,271,6,0,0,85,362
267704,373,0,0,0,4,377
267706,65,51,0,12,22,150
267707,135,55,144,5,12,351
267711,172,109,0,10,60,351
267714,61,17,0,0,2,80
267717,169,64,144,17,24,418
267719,0,57,144,11,0,212
267720,13,27,0,1,2,43
267721,172,92,143,20,34,461
267724,173,69,0,10,84,336
267728,258,69,0,8,33,368
267729,255,104,100,15,29,503
267730,148,51,144,10,18,371
267731,70,19,0,0,5,94
267732,54,11,9,0,1,75
267733,162,52,91,0,44,349
267734,121,39,0,3,1,164
267735,164,66,86,13,16,345
267738,165,92,144,10,23,434
267741,0,3,0,2,1,6
267746,30,1,144,0,0,175
267750,222,81,150,6,46,505
267758,173,66,144,11,60,454
267759,1,0,0,0,0,1
267762,134,22,0,1,9,166
267763,84,50,0,0,3,137
267764,144,50,144,4,8,350
267767,131,0,0,14,2,147
267776,186,71,144,6,74,481
267779,6,31,0,7,31,75
267782,163,109,144,11,25,452
267785,164,83,144,6,45,442
267791,124,63,0,0,14,201
267792,170,92,144,15,33,454
267795,192,3,0,1,3,199
267798,466,268,78,32,106,950
267802,103,12,0,6,6,127
267808,118,93,0,15,12,238
267812,36,36,0,0,20,92
267818,259,94,0,14,87,454
267821,159,47,65,8,8,287
267822,60,18,0,0,1,79
267824,188,27,0,0,6,221
267825,82,31,0,3,3,119
267827,194,49,144,2,15,404
267829,120,12,141,5,7,285
267830,145,27,0,7,15,194
267833,173,94,144,20,29,460
267837,339,17,0,0,64,420
267847,130,6,0,0,4,140
26785,0,0,0,0,0,0
267852,2,0,144,0,0,146
267863,164,47,0,0,50,261
267864,168,131,0,14,59,372
267865,102,34,99,7,7,249
267874,129,24,144,6,9,312
267875,195,51,144,7,20,417
267878,258,154,0,34,67,513
267882,320,168,132,13,35,668
267883,399,0,117,6,10,532
267885,182,5,0,1,3,191
267889,13,11,51,0,0,75
267891,165,79,144,5,28,421
267897,324,154,144,33,70,725
267899,165,113,143,19,46,486
267900,245,63,0,19,33,360
267903,4,0,35,0,0,39
267905,425,1,0,0,0,426
267908,107,13,144,5,7,276
267910,159,68,0,7,21,255
267912,164,104,144,27,36,475
267914,107,0,0,0,1,108
267915,65,48,0,9,3,125
267918,162,87,137,14,44,444
26792,539,35,0,1,119,694
267920,228,9,0,1,43,281
267921,108,15,0,7,7,137
26793,0,0,0,0,0,0
267933,452,0,0,5,57,514
267935,451,9,143,16,130,749
267936,638,2,143,1,131,915
267938,53,1,0,1,6,61
26794,0,0,0,0,0,0
267940,355,0,0,0,8,363
267942,158,48,0,20,96,322
267944,206,34,0,4,49,293
267949,210,0,0,0,0,210
267954,439,4,0,0,40,483
267955,456,74,285,31,274,1120
267957,405,3,0,9,48,465
267958,196,34,143,10,74,457
267961,106,4,0,6,14,130
267962,480,4,0,1,27,512
267964,487,35,143,21,290,976
267965,165,0,0,0,49,214
267969,389,1,92,20,117,619
267971,622,28,155,14,255,1074
267972,123,15,0,11,78,227
267974,479,6,143,13,138,779
267980,310,1,0,7,12,330
267981,132,5,286,9,28,460
267982,386,22,282,1,194,885
267984,340,1,0,1,61,403
267985,131,3,143,7,26,310
267986,472,5,0,3,62,542
267987,457,4,0,14,128,603
267988,431,8,286,4,248,977
267989,488,0,157,1,140,786
267990,457,4,0,10,145,616
267991,246,6,430,8,19,709
267992,200,51,132,1,115,499
267993,357,4,31,26,100,518
267996,422,0,286,13,127,848
267998,422,8,143,3,63,639
268003,85,2,280,7,0,374
268004,354,2,10,5,23,394
268006,601,9,285,12,179,1086
268007,589,6,144,6,202,947
268008,134,0,198,5,4,341
268009,116,13,2,1,20,152
26801,18,0,421,7,0,446
268012,100,10,0,13,23,146
268013,582,20,405,22,160,1189
268019,228,1,2,1,21,253
268020,331,0,0,0,67,398
268023,240,1,0,4,17,262
268025,371,4,24,8,46,453
268028,84,12,0,0,0,96
268029,0,0,0,0,0,0
268032,193,33,0,10,166,402
268033,603,4,143,10,116,876
268038,379,34,0,11,80,504
268039,56,19,0,3,23,101
268040,233,25,0,14,83,355
268041,485,12,282,23,130,932
268042,256,1,81,2,119,459
268046,318,1,2,5,7,333
268047,106,0,0,0,4,110
268048,200,32,0,14,104,350
268050,433,3,0,0,48,484
268051,454,7,144,12,143,760
268052,329,3,143,2,47,524
268054,211,15,2,1,58,287
268055,218,73,0,18,89,398
268056,469,24,143,8,30,674
268059,574,7,0,12,240,833
268060,233,2,0,4,8,247
268061,563,19,0,6,175,763
268064,525,7,0,12,189,733
268065,301,34,144,1,47,527
268066,465,12,158,7,20,662
268067,328,0,0,1,8,337
268068,294,7,143,0,39,483
268075,360,21,0,11,176,568
268077,524,3,0,9,113,649
268079,374,2,0,7,64,447
268080,453,23,0,10,110,596
268082,350,4,0,4,129,487
268083,333,6,143,0,1,483
268084,433,3,0,1,109,546
268085,478,15,286,23,155,957
268086,243,0,0,0,9,252
268089,554,4,143,8,114,823
26809,0,0,0,0,0,0
268090,466,2,0,0,41,509
268091,400,27,144,14,88,673
268094,295,0,144,4,82,525
268096,284,1,143,0,177,605
268097,482,21,0,27,258,788
268098,720,20,0,17,112,869
26810,1,0,0,1,1,3
268100,275,61,0,11,65,412
268104,377,1,258,0,11,647
268105,593,16,0,18,74,701
268106,272,22,0,16,35,345
268107,656,24,144,27,232,1083
268108,570,2,0,2,102,676
268109,212,16,0,7,115,350
268111,204,42,0,9,98,353
268113,289,6,0,1,25,321
268114,276,13,144,15,45,493
268115,135,11,0,0,25,171
268117,622,10,143,7,172,954
268122,459,55,0,17,56,587
268123,453,1,0,1,59,514
268125,175,29,0,17,91,312
268126,373,16,143,11,60,603
268127,405,8,12,0,40,465
268128,589,11,0,8,143,751
268129,413,10,0,8,65,496
268130,245,23,0,9,44,321
268131,287,9,143,7,79,525
268132,483,12,430,5,80,1010
268133,531,12,0,31,292,866
268134,210,46,193,39,62,550
268135,210,20,431,8,41,710
268136,598,10,22,9,184,823
268137,195,13,0,14,69,291
268138,420,9,0,28,210,667
268140,145,5,287,0,8,445
268142,378,5,257,1,47,688
268144,441,2,143,1,40,627
268145,285,101,144,30,151,711
268146,165,1,2,9,4,181
268148,485,4,147,20,17,673
268151,242,49,0,4,49,344
268153,243,47,285,21,17,613
268155,261,65,288,12,102,728
268156,480,11,0,19,66,576
268157,556,1,0,18,80,655
268158,186,48,0,25,79,338
268160,214,6,143,1,19,383
268161,344,7,0,4,42,397
268162,256,0,123,1,76,456
268164,404,0,143,11,34,592
268168,526,25,284,22,222,1079
268169,41,1,131,7,29,209
268170,451,11,144,12,165,783
268171,558,29,0,36,279,902
268172,559,1,143,10,47,760
268175,456,1,143,1,26,627
268176,186,2,0,1,10,199
268177,277,15,0,6,47,345
268180,98,0,144,1,18,261
268184,255,0,0,2,11,268
268185,347,69,144,27,121,708
268186,306,1,0,1,10,318
268188,455,10,52,11,77,605
268189,501,15,428,2,125,1071
268192,207,7,244,9,23,490
268194,209,64,0,5,55,333
268195,357,18,0,0,68,443
268197,339,16,143,13,181,692
268198,456,14,139,10,121,740
268199,66,15,0,3,19,103
268200,1301,56,386,60,641,2444
268201,436,6,143,9,136,730
268202,216,3,0,8,81,308
268205,304,7,0,12,90,413
268206,458,32,0,5,73,568
268207,183,5,0,6,19,213
268209,211,55,0,9,79,354
268210,257,6,143,10,3,419
268212,581,15,0,22,223,841
268214,452,7,143,4,109,715
268215,122,1,141,17,15,296
268216,741,16,288,0,99,1144
268217,166,0,82,0,12,260
268218,477,1,170,8,23,679
268219,179,17,0,6,16,218
268221,221,0,141,0,37,399
268222,594,12,0,9,209,824
268224,377,3,282,1,73,736
268225,292,3,145,17,52,509
268227,421,1,84,0,8,514
268229,429,3,144,7,57,640
268231,564,16,0,15,170,765
268233,234,41,143,20,85,523
268234,533,20,286,25,254,1118
268235,203,39,0,1,88,331
268236,426,1,0,9,19,455
268237,534,3,0,15,60,612
268238,293,0,0,0,10,303
268239,444,2,0,4,47,497
268240,504,2,0,4,39,549
268241,417,2,0,6,59,484
268243,471,0,143,0,19,633
268244,395,0,0,1,29,425
268245,150,1,0,0,3,154
268246,440,8,0,16,104,568
268247,459,2,143,4,96,704
268249,559,16,0,20,67,662
268250,267,2,143,0,7,419
268251,357,16,0,7,137,517
268252,167,2,0,0,5,174
268253,447,3,0,2,49,501
268255,616,10,0,17,142,785
268258,322,3,0,6,85,416
268259,257,1,0,1,27,286
268261,170,0,0,0,4,174
268262,351,6,143,8,140,648
268263,1,1,0,1,63,66
268266,390,0,0,1,20,411
268269,129,1,0,0,15,145
26827,14936,175,830,55,3414,19410
268270,57,1,0,0,19,77
268271,602,42,0,6,160,810
268272,422,4,286,17,152,881
268274,235,0,0,0,36,271
268275,452,7,143,23,183,808
268276,348,2,0,0,69,419
268278,240,0,143,1,43,427
268279,222,47,410,9,75,763
268280,103,1,0,3,59,166
268281,131,4,0,1,3,139
268283,565,1,141,4,22,733
268284,228,12,0,0,10,250
268285,204,1,0,4,9,218
268286,0,0,0,0,0,0
268287,603,7,143,16,170,939
268288,162,0,0,0,6,168
268289,399,2,0,0,40,441
268292,639,10,143,9,204,1005
268294,635,5,0,4,210,854
268295,581,30,0,30,176,817
268296,390,1,0,16,7,414
268297,418,9,0,23,181,631
268303,516,16,0,10,59,601
268304,385,13,0,8,127,533
268305,409,4,0,14,64,491
268308,469,4,143,5,83,704
26831,0,0,0,0,0,0
268311,604,50,143,30,391,1218
268315,268,0,0,0,19,287
268317,99,12,0,13,48,172
26832,695,33,8,26,135,897
268321,443,4,0,4,31,482
268322,152,0,0,0,0,152
268323,3697,72,470,95,1238,5572
268325,613,7,0,5,146,771
268326,191,1,0,0,0,192
268327,306,0,141,1,19,467
268330,538,36,0,16,144,734
268332,578,7,123,6,45,759
268333,489,23,0,16,266,794
268335,419,5,0,5,58,487
268336,480,12,287,16,165,960
268337,142,1,143,1,5,292
268338,100,1,143,0,2,246
268341,556,7,137,3,33,736
268342,363,1,0,0,7,371
268343,365,1,0,1,11,378
268344,433,11,0,15,166,625
268347,224,12,147,0,3,386
268350,505,2,141,2,67,717
268351,531,12,0,12,156,711
268352,127,5,65,4,19,220
268355,202,44,183,9,113,551
268359,315,2,0,1,32,350
268362,594,18,0,18,223,853
268364,366,4,286,1,185,842
268367,410,0,0,5,69,484
268369,546,3,0,13,34,596
268371,313,2,0,1,135,451
268372,471,13,0,25,181,690
268374,168,32,109,12,136,457
268376,293,1,0,1,69,364
268377,147,7,0,2,78,234
268378,107,1,0,3,17,128
268379,663,3,0,5,133,804
268380,122,39,143,14,125,443
268385,177,3,143,10,143,476
268386,113,4,0,2,101,220
268387,570,15,0,4,21,610
268388,579,23,0,2,155,759
268391,574,41,0,29,350,994
268392,476,6,0,10,98,590
268393,242,19,0,12,166,439
268394,420,0,0,0,175,595
268395,72,1,0,1,74,148
268396,557,5,0,5,120,687
268397,585,2,0,13,69,669
268399,351,2,0,8,180,541
268400,569,5,0,0,48,622
268402,379,6,0,6,57,448
268403,419,7,0,12,97,535
268405,268,1,0,7,60,336
268407,108,16,0,11,55,190
268409,553,5,0,2,120,680
268410,323,0,0,0,2,325
268411,393,0,0,7,8,408
268412,495,1,0,0,205,701
268413,385,2,0,11,17,415
268415,373,2,0,1,96,472
268418,255,38,0,4,75,372
268419,52,1,0,4,0,57
268424,311,1,0,13,24,349
268425,611,6,144,12,75,848
268426,51,1,0,0,1,53
268427,605,14,0,0,134,753
268428,329,1,0,8,81,419
268430,228,67,0,29,102,426
268431,25,0,0,0,3,28
268434,215,0,0,0,13,228
268436,319,1,0,1,16,337
26844,0,0,0,0,0,0
268440,447,2,0,2,145,596
268442,292,1,189,0,30,512
268443,454,7,0,0,37,498
268445,467,4,0,5,23,499
268446,238,11,0,1,93,343
268448,472,0,0,0,3,475
268450,343,1,0,0,5,349
268452,431,10,0,6,128,575
268453,85,2,0,2,2,91
268454,197,0,143,0,6,346
268455,438,4,0,6,51,499
268459,522,14,0,8,131,675
268462,389,1,0,10,29,429
268463,351,2,0,3,56,412
268466,473,12,0,4,141,630
268467,279,15,0,3,73,370
268468,390,1,0,0,9,400
268469,235,24,0,21,90,370
268472,153,12,0,16,41,222
268473,401,5,0,7,29,442
268474,221,0,0,0,7,228
268476,584,19,0,18,158,779
268477,316,28,0,0,73,417
268478,298,11,0,5,53,367
268480,386,26,0,12,123,547
268481,160,0,0,1,1,162
268482,434,8,143,5,166,756
268483,459,59,0,25,113,656
268485,157,1,0,4,77,239
268489,350,1,0,1,8,360
268490,304,3,0,3,13,323
268491,329,0,0,0,101,430
268492,496,23,0,11,178,708
268493,596,31,0,19,206,852
268494,413,2,0,1,43,459
268496,474,1,0,1,19,495
268500,297,2,144,0,36,479
268502,360,0,0,0,99,459
268504,601,9,0,7,186,803
268505,611,7,144,7,203,972
268506,281,1,0,1,3,286
268508,111,3,143,13,48,318
268509,539,3,0,6,94,642
268510,346,19,0,14,45,424
268513,161,0,0,1,2,164
268514,174,5,0,4,19,202
268516,622,18,0,26,197,863
268517,538,2,0,8,114,662
268520,625,13,0,26,213,877
268522,429,4,0,8,104,545
268523,409,15,0,19,237,680
268524,279,3,0,7,141,430
268525,448,20,144,31,116,759
268527,468,11,0,12,49,540
268529,163,9,0,1,39,212
268532,224,18,0,12,45,299
268534,243,0,0,0,109,352
268537,251,44,0,16,84,395
268538,377,5,0,4,37,423
26854,508,2,0,1,2,513
268540,189,11,0,1,11,212
268541,243,4,0,11,35,293
268542,186,1,141,0,4,332
268543,436,7,0,8,193,644
268546,380,8,143,2,55,588
268548,694,18,287,11,239,1249
268550,202,1,19,0,8,230
268551,41,0,0,0,37,78
268552,423,1,173,4,76,677
268554,176,6,0,11,57,250
268556,65,31,0,18,77,191
268557,494,2,0,7,61,564
268559,270,0,0,3,18,291
268560,614,3,0,11,113,741
268561,386,10,0,4,145,545
268562,276,6,0,12,169,463
268563,308,8,0,9,259,584
268565,399,0,286,8,95,788
268568,190,71,0,20,113,394
268570,389,1,0,6,189,585
268571,410,0,0,10,222,642
268572,410,0,399,1,85,895
268573,364,18,287,7,147,823
268574,397,0,0,0,14,411
268576,414,12,282,9,118,835
268578,67,0,0,0,0,67
268579,132,1,0,0,2,135
268580,188,20,0,16,127,351
268581,662,39,0,49,211,961
268583,410,1,0,2,22,435
268587,162,1,0,0,11,174
268588,181,21,144,0,38,384
268590,293,1,0,0,32,326
268592,305,6,397,8,74,790
268593,323,1,0,1,16,341
268594,19,0,143,1,1,164
268595,228,3,240,5,80,556
268596,266,1,144,2,30,443
268597,399,3,0,2,6,410
2686,414,0,26,0,0,440
26860,0,0,0,0,0,0
268600,437,19,0,5,78,539
268601,197,33,0,15,105,350
268602,366,2,0,4,44,416
268603,287,1,0,1,16,305
268605,458,26,143,38,243,908
268606,401,2,143,4,50,600
268607,579,1,141,8,133,862
268609,575,35,0,18,229,857
268610,605,1,0,17,104,727
268611,208,62,15,30,81,396
268613,160,7,19,11,55,252
268614,145,49,284,4,53,535
268616,462,26,147,11,134,780
268617,492,67,281,14,110,964
268618,403,1,0,0,8,412
268619,248,0,8,0,6,262
268621,386,3,208,7,115,719
268622,431,6,0,10,70,517
268628,552,28,0,45,297,922
268630,614,3,10,4,103,734
268631,490,19,101,33,216,859
268632,262,68,200,7,111,648
268633,179,24,0,15,35,253
268634,470,10,0,10,66,556
268635,297,8,143,3,67,518
268637,246,30,143,22,177,618
26864,0,0,48,0,0,48
268640,150,0,130,0,52,332
268641,244,11,0,4,72,331
268643,562,26,430,11,148,1177
268645,573,11,286,7,161,1038
268646,524,1,278,0,299,1102
268647,426,26,145,18,177,792
268650,251,1,141,1,126,520
268651,619,12,0,21,160,812
268653,216,0,143,5,71,435
268654,417,9,0,12,154,592
268658,417,3,0,4,53,477
268659,489,9,0,10,39,547
268660,124,0,143,6,2,275
268661,502,36,0,25,278,841
268662,356,36,0,17,89,498
268665,505,7,0,24,182,718
268667,372,1,0,0,24,397
268668,273,4,144,2,137,560
268669,215,8,345,2,36,606
268670,432,0,0,6,48,486
268671,547,14,143,8,141,853
268672,514,8,0,2,53,577
268674,260,36,0,16,69,381
268675,0,59,0,0,0,59
268676,407,29,0,5,95,536
268678,519,3,0,7,84,613
268679,257,2,0,3,66,328
268681,429,5,0,22,78,534
268682,396,0,0,0,126,522
268683,244,19,0,20,126,409
268684,464,12,0,17,207,700
268686,573,44,0,25,217,859
268689,351,13,0,19,142,525
268690,571,7,144,6,125,853
268691,419,3,144,9,76,651
268694,255,3,0,17,128,403
268695,461,3,0,11,72,547
268696,140,31,0,7,35,213
268698,695,21,0,16,274,1006
268699,378,0,0,4,17,399
2687,473,60,2,0,4,539
268700,547,0,0,13,5,565
268701,146,28,0,23,69,266
268706,120,8,141,0,22,291
268708,314,2,0,8,19,343
26871,129,0,0,0,0,129
268710,385,19,253,25,185,867
268713,259,1,223,1,4,488
268714,306,5,144,7,22,484
268715,485,2,148,13,215,863
268717,372,5,285,9,116,787
268719,406,7,144,27,181,765
268720,365,9,0,2,63,439
268721,684,9,426,20,157,1296
268723,169,5,2,6,16,198
268725,611,2,143,8,106,870
268726,591,5,143,17,37,793
268728,141,27,144,16,51,379
268729,448,5,0,11,159,623
26873,167,0,0,0,57,224
268730,386,1,0,1,32,420
268732,236,43,0,35,76,390
268733,247,1,0,4,75,327
268734,546,7,0,7,16,576
268735,467,13,0,17,160,657
268736,518,0,143,4,25,690
268738,959,19,144,31,429,1582
268740,418,1,0,1,43,463
268746,0,9,0,0,0,9
268747,510,22,0,18,226,776
268749,410,2,0,8,156,576
268751,182,1,143,0,12,338
268753,125,2,147,1,14,289
268754,242,0,0,0,2,244
268755,331,45,143,16,58,593
268756,214,2,51,1,35,303
268757,459,3,72,0,37,571
268761,279,13,283,13,153,741
268762,405,9,143,16,42,615
268764,519,2,257,5,23,806
268765,306,93,13,12,42,466
268768,151,8,132,5,7,303
268771,617,9,0,17,188,831
268772,479,34,144,24,250,931
268773,99,2,12,7,18,138
268774,214,3,144,7,40,408
268778,446,22,0,23,114,605
268781,387,12,143,14,95,651
268782,307,21,0,5,24,357
268784,188,0,144,0,0,332
268787,686,1,0,1,20,708
268788,212,0,0,4,116,332
268789,299,39,0,33,176,547
268790,268,14,0,5,25,312
268791,407,1,114,5,34,561
268793,442,5,0,0,48,495
268795,458,29,2,17,252,758
268796,561,2,0,2,30,595
268797,168,1,0,5,13,187
268798,190,0,144,6,36,376
268801,362,17,0,5,84,468
268802,311,1,0,1,144,457
268803,510,12,0,7,60,589
268804,261,0,0,0,3,264
268805,337,8,144,2,18,509
268806,330,2,141,1,3,477
268810,221,2,0,3,27,253
268811,54,1,0,0,41,96
268815,236,42,0,15,88,381
268817,353,11,0,8,132,504
268818,237,0,0,0,18,255
268821,226,7,0,4,79,316
268822,217,26,0,8,49,300
268823,290,0,0,0,7,297
268824,591,12,0,29,156,788
268828,377,21,0,7,145,550
268831,568,14,0,11,162,755
268832,463,6,144,16,121,750
268834,440,7,0,20,64,531
268838,329,2,0,0,23,354
268842,397,6,118,17,158,696
268847,342,5,0,8,71,426
268848,287,57,241,13,77,675
268853,320,34,139,7,21,521
268855,202,10,2,0,28,242
268859,316,2,273,5,12,608
268860,551,8,0,14,181,754
268861,202,1,0,0,10,213
268863,175,0,143,0,6,324
268866,462,18,141,8,153,782
268869,621,9,336,11,120,1097
268871,379,4,0,1,66,450
268873,604,70,428,46,361,1509
268874,191,0,0,13,67,271
268875,298,84,0,38,132,552
268879,384,1,0,4,26,415
268880,401,21,0,21,100,543
268881,152,0,0,4,9,165
268882,280,1,144,0,3,428
268884,370,0,0,0,8,378
268885,446,3,0,5,109,563
268886,247,1,143,1,32,424
268887,563,6,396,5,83,1053
268888,362,8,0,9,120,499
268890,90,0,0,0,26,116
268891,34,1,0,1,7,43
268892,430,8,0,7,111,556
268893,441,5,0,2,89,537
268894,124,0,0,0,2,126
268896,484,4,143,5,81,717
268899,307,17,0,26,57,407
268900,401,0,0,0,3,404
268902,199,0,0,6,59,264
268904,437,23,0,10,113,583
268905,222,43,0,8,82,355
268906,61,0,144,0,7,212
268907,20,2,0,0,0,22
268909,469,11,144,7,147,778
268910,516,0,0,8,11,535
268911,379,3,0,6,23,411
268915,543,10,287,1,144,985
268916,577,14,144,24,230,989
268917,361,1,144,5,38,549
268919,391,2,143,1,55,592
268920,457,0,144,0,78,679
268923,400,2,118,7,48,575
268924,569,6,0,21,167,763
268926,504,16,144,21,177,862
268928,364,0,0,0,5,369
268929,457,2,0,0,29,488
268931,419,20,0,35,138,612
268933,305,8,0,7,81,401
268934,615,10,143,24,140,932
26894,0,0,0,0,0,0
268940,373,6,0,5,59,443
268943,353,2,0,9,35,399
268945,213,0,0,0,88,301
268948,175,0,97,0,0,272
268951,598,18,144,17,215,992
268952,491,6,0,8,125,630
268953,238,47,0,31,81,397
268954,170,0,144,4,2,320
268955,455,4,142,10,80,691
268956,406,8,143,4,40,601
268957,31,2,144,0,1,178
268962,456,12,0,7,167,642
268964,612,9,0,14,138,773
268965,267,0,280,0,7,554
268971,440,9,0,1,87,537
268972,311,1,143,1,43,499
268976,1780,47,144,28,429,2428
268978,602,16,0,13,213,844
268980,518,1,0,0,9,528
268981,315,3,0,4,84,406
268983,508,43,143,44,311,1049
268984,535,17,0,17,160,729
268985,431,28,0,28,181,668
268987,389,6,0,3,38,436
268988,186,35,0,15,50,286
268990,580,12,430,18,240,1280
268991,304,1,0,1,76,382
268993,311,22,0,12,212,557
268994,161,17,288,3,6,475
268995,375,3,141,1,55,575
268996,370,1,143,1,9,524
268997,237,1,144,7,10,399
268999,412,63,262,17,81,835
269000,105,1,144,3,4,257
269004,455,48,0,12,71,586
269006,450,10,287,11,147,905
269007,75,1,0,1,70,147
269008,365,7,0,8,14,394
269009,276,2,0,1,9,288
269015,273,1,0,1,77,352
269016,407,2,143,20,48,620
269018,324,0,143,0,3,470
269019,410,3,144,1,18,576
269022,287,16,0,14,75,392
269023,175,4,144,0,5,328
269024,406,4,0,7,65,482
269025,431,2,0,2,54,489
269029,500,22,233,4,89,848
26903,0,0,0,0,0,0
269031,494,7,0,5,105,611
269033,402,1,143,1,7,554
269034,329,23,0,2,29,383
269035,268,2,0,2,13,285
269037,235,7,144,8,44,438
269039,475,16,107,19,213,830
269040,190,0,0,0,1,191
269043,181,0,0,4,47,232
269044,279,6,0,19,130,434
269046,505,30,144,34,133,846
269047,272,1,0,1,14,288
269050,378,0,144,6,14,542
269051,0,58,0,0,0,58
269055,408,2,0,0,41,451
269056,272,11,0,5,35,323
269057,392,4,288,11,87,782
269058,188,1,0,0,13,202
269059,548,31,0,21,110,710
269060,490,22,144,14,197,867
269062,174,2,0,1,11,188
269063,512,2,0,14,121,649
269064,531,1,0,0,3,535
269065,570,2,144,15,193,924
269067,305,2,0,0,3,310
269068,476,6,0,1,48,531
269071,205,1,0,4,2,212
269073,850,7,0,2,121,980
269074,419,10,0,8,74,511
269076,128,2,0,0,3,133
269079,256,2,0,0,3,261
269081,496,8,0,8,110,622
269084,279,36,0,5,59,379
269089,439,1,0,4,24,468
26909,0,0,0,0,0,0
269092,203,120,0,29,116,468
269093,455,9,0,2,107,573
269094,308,30,143,17,240,738
269096,382,6,431,9,89,917
269097,406,6,0,1,33,446
269098,174,1,143,2,0,320
269100,408,2,0,1,54,465
269105,433,1,0,0,18,452
269109,509,27,0,15,79,630
269110,217,51,145,14,96,523
269112,281,1,0,1,25,308
269114,388,2,287,1,44,722
269116,260,6,0,10,70,346
269118,588,40,0,20,256,904
269121,201,15,0,6,72,294
269122,281,33,0,27,62,403
269123,221,6,284,7,148,666
269125,340,0,144,20,23,527
269126,350,0,0,4,29,383
269127,591,5,144,9,124,873
269129,190,1,0,0,3,194
269130,221,0,143,0,4,368
269131,445,9,144,17,22,637
269134,40,1,0,4,6,51
269135,83,18,0,20,12,133
269136,337,2,0,0,5,344
269137,390,1,144,2,13,550
269138,432,9,0,3,272,716
269139,467,25,144,12,63,711
269140,566,25,287,7,126,1011
269141,456,1,0,0,32,489
269142,398,25,286,0,3,712
269143,454,1,141,6,106,708
269144,9,0,0,0,0,9
269145,493,4,136,24,68,725
269147,158,4,0,0,19,181
269149,166,1,0,0,6,173
269150,280,0,0,21,22,323
269151,461,17,147,14,181,820
269153,168,14,192,6,40,420
269154,400,3,14,5,23,445
269155,547,5,285,8,51,896
269156,361,6,35,4,19,425
269161,333,49,0,34,177,593
269164,244,53,143,15,103,558
269166,2,0,144,0,0,146
269168,449,2,145,3,26,625
269169,241,1,143,1,106,492
269170,503,15,139,16,194,867
269173,301,0,0,0,9,310
269179,552,30,0,20,174,776
269181,417,6,143,9,68,643
269182,533,19,0,27,205,784
269183,217,49,144,11,83,504
269184,396,8,144,14,101,663
269186,190,28,0,8,69,295
269189,428,6,0,5,137,576
26919,0,0,28,19,0,47
269192,163,12,0,9,13,197
269193,426,21,0,8,58,513
269195,453,5,0,3,115,576
269196,750,5,143,28,163,1089
269197,623,46,0,17,82,768
269199,577,7,0,22,140,746
269200,255,2,0,1,38,296
269201,302,59,0,12,135,508
269202,79,2,0,0,8,89
269203,144,1,0,0,1,146
269204,133,35,0,11,57,236
269206,585,46,0,16,202,849
269207,489,6,0,10,205,710
269208,235,42,0,7,81,365
269210,340,6,39,2,41,428
269211,94,10,287,0,22,413
269214,155,17,0,1,68,241
269215,446,24,0,22,238,730
269219,0,0,0,0,0,0
269220,452,55,0,31,257,795
269221,277,1,0,1,7,286
269222,493,25,0,7,131,656
269223,567,5,0,6,115,693
269225,65,1,0,1,85,152
269226,372,21,0,11,123,527
269227,8,0,35,0,0,43
26923,0,0,0,0,0,0
269230,464,18,0,14,154,650
269231,589,3,0,1,15,608
269232,390,5,0,6,45,446
269236,181,6,0,7,42,236
269237,308,24,0,0,11,343
269239,439,10,0,13,145,607
269240,182,1,0,1,6,190
269241,158,7,0,0,5,170
269243,586,1,0,4,75,666
269244,436,40,0,8,43,527
269246,263,36,0,26,205,530
269248,414,1,0,4,4,423
269249,621,19,0,24,113,777
269250,463,40,0,45,323,871
269251,375,15,143,38,110,681
269252,466,19,144,6,156,791
269253,311,2,0,14,14,341
269254,465,6,144,15,28,658
269256,394,5,0,11,136,546
269258,269,1,0,0,56,326
269261,533,16,0,4,33,586
269262,344,0,0,0,13,357
269263,313,0,0,0,4,317
269264,318,38,0,33,80,469
269265,201,1,0,0,4,206
269267,252,3,0,4,134,393
269268,339,0,0,4,12,355
269269,450,1,144,11,53,659
269271,340,1,0,1,13,355
269272,605,2,0,0,106,713
269275,532,1,0,0,15,548
269278,151,13,0,11,7,182
269281,459,2,0,8,67,536
269285,286,13,0,12,235,546
269286,312,2,0,1,65,380
269288,311,1,0,3,45,360
269290,432,1,144,5,45,627
269291,129,1,0,11,54,195
269293,399,11,0,11,162,583
269294,227,15,0,4,77,323
269295,418,1,0,9,46,474
269298,317,0,0,4,72,393
269299,210,1,0,8,44,263
269300,553,9,0,10,157,729
269302,83,2,0,0,2,87
269304,480,31,0,22,146,679
269305,452,0,0,2,158,612
269308,340,14,0,7,34,395
269310,574,16,0,26,182,798
269311,240,26,0,4,82,352
269312,327,35,0,16,202,580
269313,392,6,0,5,75,478
269314,270,8,0,8,65,351
269315,452,10,287,10,164,923
269316,217,6,0,14,52,289
269317,547,74,0,14,211,846
269318,114,3,144,1,6,268
269319,62,2,0,14,75,153
26932,3,0,81,0,0,84
269321,436,33,0,4,59,532
269322,282,67,144,16,178,687
269325,543,2,0,9,82,636
269327,138,48,0,34,40,260
269328,490,1,0,10,51,552
269329,15,0,0,0,1,16
269331,468,45,143,16,92,764
269333,509,12,0,4,207,732
269334,431,1,6,5,28,471
269335,359,0,143,0,4,506
269337,453,12,0,23,178,666
269338,396,9,0,24,47,476
269339,366,0,0,1,112,479
26934,0,0,0,0,0,0
269340,357,5,0,11,96,469
269343,494,2,0,7,84,587
269344,223,44,0,5,69,341
269345,651,35,0,23,260,969
269347,409,1,0,4,18,432
269348,423,4,0,7,77,511
26935,1472,69,61,2,487,2091
269351,566,12,0,19,101,698
269352,493,2,0,9,28,532
269353,248,25,0,4,107,384
269355,615,39,0,27,222,903
269356,179,0,0,0,1,180
269359,450,7,278,18,84,837
269360,391,35,0,31,80,537
269363,389,2,0,1,16,408
269364,342,31,144,22,99,638
269366,462,13,0,24,149,648
269368,459,7,0,12,198,676
269369,576,5,0,18,138,737
269370,478,39,0,31,146,694
269372,442,9,0,2,207,660
269374,408,4,0,18,25,455
269377,463,22,136,7,147,775
269378,377,26,135,10,125,673
269380,314,7,144,1,16,482
269381,45,0,143,0,0,188
269383,226,42,0,23,74,365
269385,631,19,0,20,218,888
269386,371,4,9,7,148,539
269387,310,0,139,1,3,453
269388,149,5,0,1,14,169
269389,413,2,144,3,82,644
269391,327,7,8,5,43,390
269393,151,0,144,0,6,301
269394,0,1,0,0,1,2
269396,518,22,271,4,29,844
269399,321,3,0,12,39,375
269401,472,24,0,13,91,600
269402,376,3,143,0,17,539
269403,392,6,0,10,208,616
269405,536,10,277,12,207,1042
269407,263,4,0,0,36,303
269409,189,39,143,28,100,499
269413,8,1,141,1,14,165
269414,449,6,13,10,87,565
269415,216,1,139,0,3,359
269416,153,70,132,16,100,471
269417,267,3,143,6,17,436
269419,108,1,128,9,33,279
269420,460,4,287,1,94,846
269422,208,2,159,1,17,387
269425,576,6,0,15,102,699
269427,508,2,0,4,46,560
269431,231,5,0,6,64,306
269434,312,10,0,15,64,401
269435,272,11,0,11,38,332
269437,437,1,0,1,5,444
269439,96,1,0,4,17,118
269442,568,5,144,7,46,770
269443,417,4,143,4,65,633
269444,294,13,143,20,135,605
269445,345,1,0,1,28,375
269446,362,1,0,0,3,366
269447,368,4,0,6,85,463
269449,88,0,0,6,8,102
269450,371,2,143,0,25,541
269452,372,1,0,6,51,430
269453,563,10,141,13,156,883
269455,374,0,0,0,31,405
269456,317,7,32,1,0,357
269457,211,4,120,5,11,351
269459,616,31,246,7,67,967
269460,314,0,0,1,9,324
269462,435,23,0,25,172,655
269463,62,2,0,0,13,77
269464,266,0,0,0,60,326
269467,878,3,145,1,29,1056
269468,433,3,2,5,0,443
269469,208,2,0,1,49,260
269471,318,12,0,14,64,408
269472,473,0,46,0,36,555
269474,424,25,0,31,192,672
269475,401,1,143,3,65,613
269476,509,7,0,12,81,609
269477,267,45,143,27,71,553
269479,408,3,139,6,52,608
269483,190,1,143,1,23,358
269484,406,0,0,4,3,413
269487,510,4,0,1,24,539
269488,148,66,0,13,67,294
269489,256,3,0,8,53,320
26949,0,0,0,0,0,0
269493,359,1,144,0,194,698
269494,191,4,287,24,9,515
269495,132,10,185,36,17,380
269496,303,7,44,11,33,398
269500,429,0,0,0,20,449
269501,375,4,0,17,85,481
269502,199,0,0,0,2,201
269505,466,7,143,3,152,771
269506,204,63,0,26,96,389
269507,323,2,143,4,39,511
269509,398,38,360,18,91,905
269511,490,1,282,14,113,900
269512,527,3,400,20,124,1074
269513,598,7,0,2,128,735
269515,563,7,144,6,201,921
269516,264,6,15,3,83,371
269517,390,6,131,9,67,603
269520,343,0,141,1,22,507
269523,477,2,287,5,233,1004
269524,207,40,197,7,64,515
269525,47,17,0,7,16,87
269526,590,11,143,21,73,838
269528,120,19,0,1,48,188
269529,503,18,287,17,234,1059
269533,445,8,0,20,137,610
269535,516,4,143,8,101,772
269537,106,5,0,1,2,114
269540,499,1,286,1,16,803
269542,209,41,143,19,71,483
269545,395,2,276,0,242,915
269547,588,20,4,20,147,779
269552,462,5,143,5,60,675
269553,240,39,144,22,83,528
269554,614,42,143,17,278,1094
269555,28,1,0,0,0,29
269557,386,2,141,1,1,531
269564,412,2,282,1,19,716
269565,132,12,0,2,6,152
269566,487,0,0,0,14,501
269568,595,10,268,9,203,1085
269569,599,11,2,21,181,814
269570,349,16,89,4,74,532
269571,526,3,280,11,133,953
269572,527,21,143,29,261,981
269574,544,1,144,3,33,725
269575,452,0,143,3,17,615
269576,205,2,49,0,10,266
269578,163,17,142,6,53,381
269579,444,13,0,8,67,532
269580,235,3,0,3,15,256
269583,264,0,0,2,12,278
269584,489,1,284,3,57,834
269585,352,0,102,2,17,473
269587,440,3,269,1,93,806
269588,211,7,143,20,60,441
269597,286,32,154,29,179,680
269598,562,21,270,10,304,1167
269599,392,1,144,5,163,705
269600,233,1,0,9,5,248
269601,619,13,144,17,115,908
269606,347,1,0,0,12,360
269612,196,0,19,0,5,220
269614,414,1,0,0,32,447
269615,529,69,286,23,162,1069
269616,128,45,0,12,63,248
269617,469,10,144,8,94,725
269619,589,16,0,28,151,784
269620,194,0,143,0,2,339
269622,747,79,0,27,377,1230
269624,585,14,282,16,139,1036
269625,130,2,0,1,17,150
269626,357,0,141,7,20,525
269627,292,1,0,1,14,308
269628,466,21,143,11,157,798
269630,527,10,294,9,96,936
269631,121,2,92,0,14,229
269632,363,25,0,20,172,580
269635,484,16,0,13,69,582
269636,712,17,144,16,332,1221
269637,156,39,286,6,30,517
269639,608,1,282,0,363,1254
269640,473,21,114,30,312,950
269641,579,6,2,1,86,674
269642,230,0,0,13,13,256
269643,531,3,283,13,137,967
269644,399,6,137,1,64,607
269649,245,0,282,0,5,532
269650,383,3,132,2,14,534
269654,243,5,139,29,111,527
269656,512,11,422,11,82,1038
269657,112,2,0,3,4,121
269661,158,1,2,15,12,188
269662,422,40,145,25,266,898
269664,140,0,141,4,7,292
269665,481,4,134,14,97,730
269667,631,7,376,13,254,1281
269668,179,29,141,26,67,442
269670,465,62,0,13,115,655
269672,298,2,0,1,2,303
269673,465,6,0,16,68,555
269674,711,21,287,19,309,1347
269676,440,2,0,0,18,460
269677,584,4,0,5,82,675
269680,197,48,0,14,78,337
269681,16,0,0,0,0,16
269682,272,15,0,10,117,414
269683,583,10,0,8,153,754
269684,462,73,0,49,254,838
269685,530,21,0,15,185,751
269686,523,7,0,1,64,595
269687,561,5,143,13,72,794
269688,174,3,0,14,30,221
269690,447,9,0,1,17,474
269691,432,5,0,0,87,524
269692,352,0,0,1,197,550
269693,102,5,0,9,12,128
269698,507,8,147,1,49,712
269700,230,48,287,21,55,641
269703,303,9,0,10,56,378
269705,427,5,184,2,120,738
269706,519,3,141,0,35,698
269707,366,8,0,4,62,440
269708,490,7,286,24,127,934
269714,509,22,286,23,225,1065
269715,628,28,0,25,191,872
269717,376,3,0,0,21,400
269720,451,32,286,23,158,950
269723,337,1,0,2,27,367
269725,317,9,267,2,21,616
269726,198,1,0,0,18,217
269733,618,331,443,68,303,1763
269747,158,82,0,1,34,275
269748,315,13,0,15,97,440
269752,171,52,0,11,3,237
269754,139,38,0,1,17,195
269757,117,24,0,11,20,172
269759,315,79,0,27,77,498
269762,144,54,0,10,12,220
269767,136,36,0,4,11,187
269768,364,108,0,8,63,543
269776,125,34,144,2,15,320
269778,151,97,130,7,27,412
269779,302,99,144,20,27,592
269781,150,95,0,10,39,294
269783,423,9,141,8,159,740
269785,0,6,0,0,0,6
269793,178,26,144,1,15,364
269794,160,1,0,3,22,186
269795,145,82,0,9,12,248
2698,0,0,0,0,0,0
269802,170,90,144,12,13,429
269808,121,58,0,4,10,193
269809,54,1,144,0,2,201
269814,106,56,0,15,17,194
269818,157,88,144,8,31,428
269819,157,68,131,3,20,379
269823,131,56,143,7,12,349
269828,146,90,0,7,46,289
269833,290,143,148,9,47,637
269847,149,62,100,8,22,341
269849,1,15,132,10,0,158
269854,123,84,144,4,23,378
269858,163,81,138,1,17,400
269860,68,58,129,5,1,261
269870,168,115,0,13,32,328
269872,78,21,2,5,3,109
269873,118,31,4,0,3,156
269874,167,99,8,11,37,322
269878,447,21,145,5,62,680
269886,151,16,0,5,12,184
269887,266,0,0,0,4,270
269890,165,77,0,5,33,280
269897,178,106,144,14,44,486
269905,268,2,265,2,1,538
269906,40,147,144,27,9,367
269909,173,81,144,9,36,443
269910,129,34,0,6,30,199
269911,90,25,129,0,3,247
269912,143,75,74,11,20,323
269915,149,39,6,2,8,204
269917,159,75,0,12,30,276
269924,272,93,100,12,28,505
269929,94,24,13,1,10,142
269932,630,5,172,9,81,897
269933,55,10,144,2,1,212
269943,167,96,140,14,38,455
269944,95,38,0,6,15,154
269949,142,14,141,0,8,305
269952,155,71,0,14,27,267
269957,1,0,0,0,2,3
269968,129,46,144,7,5,331
269970,48,2,96,0,1,147
269976,199,2,0,7,5,213
269978,0,0,0,0,1,1
269979,49,7,0,1,5,62
269987,158,22,144,0,1,325
269988,56,37,127,7,7,234
269993,213,50,144,3,17,427
269995,0,12,0,1,0,13
269996,139,66,0,8,19,232
27,1305,1,4,1,51,1362
270,0,0,0,0,0,0
270000,37,13,144,6,1,201
270002,177,86,89,1,23,376
270004,199,49,143,8,38,437
270008,16,0,0,0,1,17
270011,168,77,0,0,32,277
270015,166,104,144,16,38,468
270017,41,0,0,0,0,41
270021,294,107,0,13,6,420
270024,72,38,141,5,10,266
270029,4,0,0,0,1,5
270034,154,45,0,5,40,244
270041,160,81,40,7,29,317
270047,149,57,143,7,15,371
27005,0,0,0,0,0,0
270052,640,4,0,1,44,689
270053,149,72,144,11,24,400
270060,100,24,141,2,5,272
270063,146,36,0,2,9,193
270070,259,102,128,16,36,541
270077,154,92,0,10,12,268
270089,198,132,0,10,36,376
270099,161,77,0,11,26,275
2701,0,0,0,0,0,0
270101,101,19,110,0,3,233
270102,100,44,0,4,20,168
270106,99,27,0,4,11,141
270117,0,0,0,0,0,0
27017,10364,1640,426,113,6220,18763
270241,426,0,141,5,83,655
270242,337,2,143,3,14,499
270244,272,12,143,9,57,493
270245,321,3,159,1,65,549
270246,401,8,26,16,83,534
270247,267,0,0,0,6,273
270248,526,30,141,29,272,998
270249,63,6,143,3,2,217
270251,342,0,89,11,100,542
270252,619,11,126,8,15,779
270253,619,17,284,13,307,1240
270254,320,1,259,4,2,586
270255,141,1,35,0,0,177
270257,528,8,278,9,36,859
270258,507,37,0,39,195,778
27026,1384,27,26,7,325,1769
270260,223,3,181,1,43,451
270262,353,11,15,20,62,461
270263,224,41,13,24,77,379
270264,396,7,4,29,76,512
270266,458,4,0,4,50,516
270267,97,0,0,0,99,196
270268,414,6,0,9,65,494
270269,449,13,0,21,176,659
270270,284,5,20,3,118,430
270272,252,0,0,0,34,286
270273,207,17,244,1,53,522
270279,593,7,301,13,130,1044
270283,344,1,0,0,14,359
270285,484,2,0,1,26,513
270286,491,1,0,0,45,537
270287,429,12,144,4,117,706
270288,441,0,372,0,126,939
270291,593,6,0,14,167,780
270292,312,2,59,1,14,388
270293,164,12,113,6,48,343
270294,498,20,250,32,252,1052
270295,607,5,0,14,121,747
270296,422,11,6,7,27,473
270298,372,6,0,0,28,406
270301,263,18,150,17,117,565
270302,481,17,0,19,194,711
270303,344,19,0,24,209,596
270304,388,0,0,0,61,449
270306,470,3,227,19,101,820
270307,509,6,186,8,112,821
270311,449,1,0,5,59,514
270312,647,18,84,15,186,950
270313,420,0,0,1,18,439
270315,238,6,0,11,159,414
270316,456,45,0,21,126,648
270320,457,11,0,10,96,574
270322,101,0,106,0,4,211
270324,444,2,143,0,30,619
270325,479,39,0,23,238,779
270330,174,6,85,7,66,338
270332,239,6,141,11,34,431
270333,323,2,0,7,21,353
270335,538,2,21,4,37,602
270336,329,1,143,7,33,513
270340,493,8,146,13,124,784
270341,345,2,143,6,15,511
270342,405,3,143,11,139,701
270343,73,7,0,0,8,88
270347,417,0,0,0,258,675
270349,96,0,0,1,2,99
270350,417,11,0,9,138,575
270352,500,13,145,19,148,825
270355,626,49,0,11,344,1030
270356,433,9,0,3,80,525
270358,599,54,0,26,159,838
270359,331,0,0,0,72,403
270361,984,18,0,16,231,1249
270362,325,5,0,3,83,416
270363,246,22,0,13,175,456
270364,607,9,143,7,168,934
270366,430,18,0,0,166,614
270367,438,2,144,2,67,653
270372,413,4,0,22,166,605
270375,660,15,0,21,302,998
270381,154,1,0,2,7,164
270382,597,13,143,6,171,930
270383,249,1,0,0,41,291
270386,389,0,0,0,15,404
270387,31,0,0,0,22,53
270391,543,6,0,17,234,800
270393,279,21,0,31,148,479
270395,335,2,0,5,50,392
270396,233,3,0,1,20,257
270399,436,3,0,5,133,577
270400,304,6,0,4,82,396
270401,551,24,0,9,0,584
270404,289,15,143,5,31,483
270405,375,0,286,0,11,672
270412,213,1,0,0,15,229
270414,474,3,0,0,149,626
270415,361,18,143,23,169,714
270417,571,1,0,4,103,679
270419,580,3,135,8,80,806
270422,145,40,0,7,57,249
270423,311,0,132,0,100,543
270425,406,8,0,28,142,584
270429,542,4,0,6,43,595
270430,394,3,0,12,44,453
270431,158,0,141,0,2,301
270435,133,2,0,0,51,186
270436,226,58,6,18,74,382
270440,197,1,46,2,7,253
270442,591,17,393,10,227,1238
270443,241,0,0,0,6,247
270444,597,95,0,11,133,836
270445,263,0,141,0,1,405
270448,103,53,8,17,30,211
270450,369,0,144,7,13,533
270451,160,0,0,0,4,164
270453,434,2,269,1,49,755
270454,289,0,4,1,2,296
270456,389,3,146,0,34,572
270460,552,13,141,13,113,832
270462,508,3,141,4,39,695
270463,699,17,280,7,129,1132
270466,426,1,265,8,19,719
270467,145,28,0,22,57,252
270470,235,0,0,1,31,267
270473,264,1,270,0,38,573
270476,267,1,0,10,31,309
270477,447,13,152,27,103,742
270481,290,1,0,5,30,326
270482,274,0,0,2,28,304
270484,457,31,0,31,269,788
270486,544,8,0,1,172,725
270488,187,18,0,1,21,227
270489,492,3,0,20,137,652
270490,426,1,287,2,12,728
270491,315,0,144,0,5,464
270495,474,13,0,23,233,743
270496,261,56,0,13,84,414
2705,0,0,0,0,0,0
270500,430,4,362,4,70,870
270504,452,0,0,0,37,489
270505,192,2,0,3,20,217
270507,465,1,144,1,75,686
270509,629,16,0,24,259,928
270512,617,35,0,12,336,1000
270514,461,57,0,12,137,667
270515,194,0,0,2,3,199
270518,425,7,0,18,80,530
270522,470,20,0,23,130,643
270523,557,3,0,1,11,572
270528,488,19,0,44,98,649
270529,86,15,0,4,51,156
270532,457,4,0,13,84,558
270533,77,18,0,13,42,150
270534,98,0,0,0,2,100
270536,601,29,0,25,188,843
270538,309,10,0,1,131,451
270539,162,23,0,1,20,206
270540,294,3,143,0,13,453
270541,632,12,0,17,205,866
270542,568,16,284,1,118,987
270543,441,4,0,14,116,575
270544,86,1,0,0,1,88
270546,303,1,0,7,16,327
270548,0,1,135,0,0,136
270549,48,6,252,0,15,321
270550,612,6,245,10,164,1037
270552,373,14,0,6,108,501
270556,543,15,2,16,86,662
270558,595,2,0,1,77,675
270559,178,2,0,1,42,223
270560,318,0,55,0,3,376
270565,381,5,0,2,66,454
270566,193,20,143,12,52,420
270567,204,0,0,0,35,239
270568,518,3,0,2,70,593
270569,617,25,0,11,214,867
270572,264,0,0,3,2,269
270573,64,1,11,0,63,139
270574,557,17,287,9,126,996
270576,549,22,0,0,215,786
270577,390,3,0,10,8,411
270581,545,16,0,28,231,820
270582,339,3,0,4,4,350
270583,387,2,0,4,16,409
270584,190,0,0,0,5,195
270585,378,23,0,23,79,503
270586,460,4,139,9,169,781
270587,617,25,141,18,226,1027
270588,701,33,0,0,55,789
270589,471,3,0,8,153,635
270590,338,1,0,0,178,517
270592,603,10,0,15,190,818
270595,216,35,0,10,61,322
270597,574,18,0,13,182,787
270598,608,16,0,18,183,825
270599,56,18,0,6,13,93
270600,569,3,0,8,17,597
270601,455,0,0,0,145,600
270602,5,7,0,0,0,12
270604,478,8,0,14,109,609
270607,395,1,0,0,30,426
270611,649,36,0,21,133,839
270613,341,1,0,0,58,400
270616,498,4,348,18,102,970
270619,276,27,0,26,81,410
270620,348,0,0,13,59,420
270624,28,0,0,0,1,29
270625,482,4,0,9,82,577
270626,473,5,0,6,86,570
270627,384,5,0,23,89,501
270628,436,5,0,12,148,601
270629,384,6,0,20,107,517
270630,231,5,0,10,46,292
270632,65,9,0,6,36,116
270634,144,17,0,4,37,202
270635,395,2,0,1,118,516
270636,54,18,134,19,20,245
270638,20,0,9,0,1,30
270639,244,6,0,9,83,342
270640,691,7,0,12,129,839
270646,647,4,0,8,22,681
270649,181,0,0,0,3,184
270650,429,2,143,7,39,620
270652,627,7,0,21,208,863
270653,648,6,143,22,170,989
270654,529,11,143,15,216,914
270656,550,28,144,25,234,981
270657,220,51,141,24,100,536
270658,587,69,0,3,40,699
270660,466,3,0,4,78,551
270662,324,6,139,9,66,544
270664,364,5,144,8,46,567
270669,458,1,267,6,63,795
270671,291,0,2,1,13,307
270672,227,2,137,13,23,402
270673,524,23,0,20,261,828
270677,646,9,0,1,34,690
270678,216,0,0,0,50,266
270679,300,2,0,7,21,330
270682,71,1,0,8,0,80
270683,337,3,0,1,48,389
270686,310,1,0,0,25,336
270687,350,1,0,0,23,374
270690,430,3,137,9,135,714
270691,555,8,0,10,235,808
270692,263,41,0,35,202,541
270697,340,11,0,9,103,463
270698,546,13,143,16,290,1008
270699,562,1,0,7,62,632
270701,334,0,0,7,39,380
270702,24,0,2,0,1,27
270703,423,1,287,4,37,752
270704,237,57,0,26,51,371
270707,3,0,0,0,0,3
270712,484,11,0,9,48,552
270713,356,9,0,7,24,396
270714,520,24,0,19,159,722
270715,262,10,0,5,36,313
270717,383,2,139,1,3,528
270718,180,4,0,10,32,226
270719,199,5,278,0,4,486
270720,318,1,0,0,16,335
270722,191,23,141,7,36,398
270723,582,42,286,37,248,1195
270725,83,24,143,4,142,396
270728,74,28,16,26,9,153
270729,417,2,141,3,32,595
270733,373,5,0,6,90,474
270742,610,6,0,11,140,767
270744,286,3,98,1,61,449
270745,0,63,0,8,0,71
270747,186,0,0,0,3,189
270748,16,0,0,0,0,16
270749,529,10,0,3,85,627
270753,444,2,0,4,38,488
270755,527,8,0,3,192,730
270760,245,0,0,1,66,312
270763,96,6,0,6,22,130
270766,373,7,123,0,4,507
270767,518,2,127,14,72,733
270768,219,0,121,0,1,341
270771,553,13,0,8,165,739
270772,319,1,0,0,11,331
270773,434,2,155,7,84,682
270776,452,7,283,16,122,880
270780,242,0,0,0,0,242
270781,314,4,143,8,48,517
270782,411,6,0,29,102,548
270784,11,0,255,0,0,266
270788,577,3,0,7,149,736
270791,535,17,0,9,236,797
270794,402,10,403,7,205,1027
270795,373,7,0,5,30,415
270796,543,38,0,33,239,853
270798,548,0,0,4,33,585
270801,218,3,369,11,80,681
270802,420,1,0,19,107,547
270803,311,1,228,0,21,561
270805,8,1,112,0,0,121
270806,226,1,13,5,30,275
270809,488,5,0,15,187,695
270812,8,0,0,0,19,27
270814,391,2,36,8,44,481
270816,213,19,0,13,36,281
270817,1,0,35,0,0,36
270819,595,13,144,27,246,1025
270820,387,3,4,5,62,461
270821,5,0,143,0,0,148
270822,268,0,132,1,5,406
270826,558,5,146,13,217,939
270827,661,8,336,19,67,1091
270828,397,1,0,4,38,440
270830,588,16,0,4,114,722
270833,351,1,137,9,23,521
270834,321,23,143,11,23,521
270835,555,1,118,15,41,730
270837,405,6,0,8,116,535
270838,357,0,0,1,83,441
270839,196,38,6,17,60,317
270843,379,6,141,14,138,678
270844,11,0,286,0,0,297
270846,317,36,137,29,75,594
270848,307,0,0,0,12,319
270849,677,0,0,9,55,741
270851,242,1,0,0,9,252
270852,453,1,139,1,40,634
270855,217,36,0,14,83,350
270857,536,3,144,8,58,749
270860,270,5,0,2,121,398
270861,271,8,0,11,63,353
270862,510,29,0,11,134,684
270863,517,2,0,0,37,556
270865,350,3,0,3,38,394
270866,441,10,0,3,96,550
270868,164,43,0,14,80,301
270869,546,7,0,7,128,688
270870,287,36,0,20,77,420
270873,467,6,139,8,74,694
270875,557,19,0,14,184,774
270876,512,42,0,24,191,769
270877,464,1,0,3,61,529
270878,213,0,0,1,6,220
270882,295,6,0,7,54,362
270883,26,4,0,0,1,31
270884,472,14,0,30,164,680
270888,293,5,0,1,44,343
270890,423,3,0,10,28,464
270893,579,1,143,2,39,764
270894,383,0,144,0,7,534
270896,113,4,0,0,7,124
270897,446,1,0,12,116,575
270899,533,5,0,0,23,561
270900,448,2,0,10,59,519
270901,274,37,0,13,107,431
270903,387,2,0,8,18,415
270904,445,11,0,11,125,592
270905,484,1,0,4,12,501
270906,430,4,0,2,87,523
270910,196,54,0,9,70,329
270912,248,2,257,6,13,526
270913,303,5,0,12,9,329
270914,387,2,141,11,19,560
270915,493,20,144,7,123,787
270916,617,21,0,33,376,1047
270918,483,3,0,4,82,572
270920,236,5,27,0,23,291
270921,525,35,0,25,201,786
270922,145,0,0,0,4,149
270923,323,1,10,2,23,359
270924,584,1,421,8,142,1156
270925,56,11,141,8,6,222
270926,387,2,121,0,14,524
270927,455,10,136,9,95,705
270930,433,1,0,1,33,468
270931,297,28,0,5,58,388
270934,428,11,144,9,165,757
270935,125,28,149,23,54,379
270936,425,1,272,6,38,742
270938,225,62,19,34,107,447
270939,203,2,210,1,18,434
270940,617,35,99,20,211,982
270942,302,5,0,3,101,411
270943,397,8,0,24,71,500
270944,385,6,0,3,35,429
270947,433,1,319,0,57,810
270948,374,9,223,8,58,672
270949,448,55,0,39,263,805
270950,50,0,0,0,4,54
270953,23,1,12,0,2,38
270960,234,0,0,7,8,249
270961,649,10,271,15,124,1069
270962,354,6,0,11,78,449
270963,427,41,0,13,73,554
270964,493,27,144,3,118,785
270965,499,0,135,4,43,681
270971,340,1,0,1,39,381
270972,269,1,0,3,27,300
270973,16,0,0,0,0,16
270974,294,0,0,0,78,372
270975,20,0,0,1,7,28
270976,454,1,0,1,109,565
270977,491,8,0,14,41,554
270979,588,49,290,27,214,1168
270986,439,7,0,2,224,672
270988,556,2,0,4,99,661
270990,360,1,0,2,117,480
270993,209,11,0,4,34,258
270994,265,1,0,1,8,275
270995,424,3,273,0,189,889
270999,162,4,0,5,1,172
271,1499,9,0,1,290,1799
271003,158,6,0,5,7,176
271004,603,3,0,0,63,669
271005,330,40,0,0,5,375
271007,538,13,0,3,113,667
271008,224,18,139,5,48,434
271011,640,12,48,20,141,861
271012,573,16,0,19,137,745
271013,252,2,144,0,8,406
271015,412,3,0,5,143,563
271016,388,3,0,0,55,446
271018,605,18,379,25,208,1235
271020,576,5,0,24,149,754
271023,445,23,0,17,194,679
271024,350,13,144,17,148,672
271025,204,26,143,22,49,444
271027,491,16,0,25,142,674
271031,543,1,0,0,18,562
271032,270,0,6,0,5,281
271034,524,5,144,7,203,883
271036,266,1,0,2,16,285
271042,575,14,0,16,177,782
271044,216,0,0,1,1,218
271045,435,5,0,13,257,710
271049,209,2,0,0,1,212
271052,429,7,0,16,39,491
271055,151,20,0,1,52,224
271059,554,8,0,9,123,694
271060,251,67,0,39,100,457
271062,446,13,0,23,100,582
271063,615,19,0,9,183,826
271064,168,4,0,9,38,219
271066,405,6,0,2,35,448
271067,281,10,0,10,45,346
271068,0,0,0,0,0,0
271071,289,34,0,18,78,419
271073,376,8,0,10,174,568
271074,5,0,0,0,0,5
271075,411,5,0,15,106,537
271076,504,9,0,13,185,711
271080,176,50,0,19,120,365
271081,453,5,143,14,150,765
271082,347,4,266,0,40,657
271085,371,2,0,1,37,411
271087,479,3,0,5,100,587
271088,484,1,139,5,94,723
271089,401,4,0,1,11,417
271090,422,7,0,7,45,481
271091,535,19,0,8,98,660
271094,151,0,0,0,11,162
271095,278,8,0,6,27,319
271096,372,12,0,7,85,476
271097,369,1,0,11,78,459
271098,213,6,0,11,18,248
271099,536,7,0,25,138,706
2711,2383,7,707,2,146,3245
271101,69,0,0,0,6,75
271105,341,9,0,1,10,361
271108,74,0,0,0,0,74
271110,452,1,30,0,14,497
271113,339,36,0,4,63,442
271115,539,12,141,8,165,865
271117,436,10,141,13,170,770
271118,242,3,0,1,25,271
271121,646,7,419,30,242,1344
271125,113,5,0,17,4,139
271128,319,1,0,1,7,328
271129,420,1,0,1,32,454
271130,244,5,0,19,47,315
271131,610,23,0,8,189,830
271136,98,2,0,0,4,104
271138,171,0,0,2,4,177
271142,257,9,141,6,86,499
271143,541,10,0,8,105,664
271144,362,1,0,3,92,458
271147,337,7,0,10,112,466
271150,489,5,0,0,45,539
271164,476,15,0,27,119,637
271165,372,12,0,6,38,428
271166,207,3,0,0,2,212
271169,444,6,0,14,83,547
271170,543,28,0,12,163,746
271172,442,2,0,3,18,465
271173,610,11,139,21,134,915
271177,56,0,0,3,1,60
271181,236,75,141,36,83,571
271182,474,7,139,10,183,813
271183,768,0,144,0,132,1044
271184,293,30,0,14,53,390
271186,280,16,141,5,50,492
271189,359,3,0,5,101,468
271193,296,75,0,27,137,535
271196,176,0,0,0,5,181
271197,379,1,0,6,24,410
271198,316,1,0,1,20,338
271202,472,4,0,3,77,556
271203,390,2,0,4,54,450
271205,330,17,0,17,75,439
271206,448,14,0,18,228,708
271207,399,21,0,11,122,553
271210,502,3,0,2,71,578
271211,387,2,0,1,14,404
271218,464,17,0,10,153,644
271222,187,2,0,0,60,249
271224,395,0,0,0,19,414
271233,314,0,0,7,36,357
271234,427,5,0,5,105,542
271237,270,22,0,4,56,352
271240,354,1,0,3,13,371
271243,121,2,143,2,4,272
271245,215,4,69,6,31,325
271247,430,0,144,7,37,618
271251,281,2,0,2,8,293
271252,427,2,69,16,103,617
271253,225,1,0,7,55,288
271257,295,1,230,0,3,529
271259,554,5,236,1,81,877
271262,532,11,167,15,120,845
271263,167,7,0,9,5,188
271264,271,4,285,9,68,637
271266,585,8,196,13,134,936
271267,366,19,0,5,81,471
271268,611,37,143,39,338,1168
271270,315,2,139,2,12,470
271272,411,0,218,7,29,665
271277,431,1,71,4,107,614
271280,338,1,247,0,27,613
271282,162,1,0,0,4,167
271290,496,6,413,4,148,1067
271293,202,60,0,12,90,364
271427,228,14,96,31,182,551
271443,226,27,414,23,24,714
2715,2467,349,601,7,53,3477
2716,2227,40,222,16,170,2675
27176,0,0,0,0,0,0
271776,90,16,8,1,8,123
271783,76,13,2,0,34,125
271788,65,22,0,2,7,96
271794,70,30,27,4,1,132
271811,70,1,118,1,1,191
271817,162,42,143,7,29,383
271846,171,40,0,7,59,277
27192,0,0,0,0,0,0
27202,1,0,0,0,0,1
27204,0,0,0,0,0,0
27216,32,0,0,0,0,32
2722,0,0,0,0,0,0
27221,0,0,0,0,0,0
27231,12,0,0,0,0,12
27235,0,0,0,0,0,0
27257,0,0,0,0,0,0
27258,0,0,0,0,0,0
2726,491,37,2,0,92,622
27261,0,0,0,0,0,0
27264,3,0,0,0,0,3
2727,2,0,20,0,0,22
2728,0,0,0,0,0,0
27283,0,0,0,0,0,0
27288,1909,18,42,10,399,2378
27294,0,0,0,0,0,0
27298,0,0,0,0,0,0
2731,1,0,0,0,0,1
2732,0,0,0,0,0,0
27336,110,0,0,3,0,113
27338,0,0,0,0,0,0
27348,54,0,10,0,4,68
2735,499,250,90,4,392,1235
27353,0,0,0,0,0,0
27364,0,0,0,0,13,13
27370,0,0,46,0,0,46
27409,620,22,15,1,24,682
27419,0,0,0,0,0,0
27425,0,0,0,0,0,0
27446,1601,20,628,61,400,2710
27448,74,2,28,0,1,105
27501,0,0,143,6,0,149
27569,277,0,65,1,36,379
27589,0,0,0,0,0,0
27611,16,9,54,30,0,109
2764,14398,2597,716,237,5262,23210
27651,2955,862,101,112,820,4850
27652,203,7,0,2,7,219
27659,255,90,173,14,9,541
27669,1188,16,157,9,15,1385
27688,633,380,0,79,487,1579
2769,0,0,0,0,0,0
27693,3756,49,421,44,978,5248
27697,220,9,0,12,38,279
27699,97323,894,2146,861,36443,137667
27715,2261,37,0,70,143,2511
27720,733,37,197,22,44,1033
27725,0,0,0,0,0,0
27747,2737,927,291,73,816,4844
27751,2035,493,9,111,392,3040
27754,495,168,93,34,107,897
27756,76,19,0,0,2,97
27768,446,108,430,28,33,1045
27787,1404,483,573,54,160,2674
27790,69,1,0,0,1,71
27792,1104,787,358,74,292,2615
27795,165,0,100,3,0,268
27813,2446,714,97,91,147,3495
27818,1053,251,11,15,68,1398
27823,73,32,376,4,11,496
27827,1262,321,157,38,89,1867
27833,1952,455,117,19,193,2736
27839,164,71,8,8,50,301
27851,548,110,139,14,61,872
27865,321,102,78,9,37,547
27866,2191,533,805,5,244,3778
27870,181,67,13,0,52,313
27877,528,206,101,12,132,979
27879,367,190,0,23,73,653
27881,1399,326,144,35,117,2021
27895,2033,537,581,75,199,3425
27901,2333,1237,435,239,1338,5582
27925,307,89,0,0,9,405
27926,362,127,141,21,40,691
27927,1282,358,296,31,144,2111
27928,0,0,0,0,0,0
27934,158,70,144,13,33,418
27935,181,98,0,6,29,314
27940,129,116,235,28,17,525
27950,154,13,0,0,11,178
27953,2101,756,378,35,289,3559
27955,1045,219,288,3,138,1693
27960,1073,195,0,17,69,1354
27964,939,456,289,74,276,2034
27967,161,111,8,2,14,296
27971,349,173,6,13,89,630
27976,692,375,224,55,150,1496
27979,255,128,27,4,65,479
27983,10484,2884,860,293,1447,15968
27984,2328,499,399,31,198,3455
27987,549,131,146,6,101,933
27988,208,202,0,30,23,463
2799,111,0,0,0,0,111
27995,386,272,26,1,330,1015
27996,319,25,139,3,26,512
27997,712,501,215,40,184,1652
28009,1189,233,80,40,117,1659
28015,6672,2500,755,408,2493,12828
28023,188,112,2,1,38,341
28026,184,140,34,10,25,393
28034,41,1,0,0,0,42
28037,124,80,0,0,2,206
28038,1282,212,210,1,121,1826
28048,1053,479,189,89,316,2126
28051,178,15,0,0,22,215
28065,180,80,141,8,16,425
28066,684,489,128,67,240,1608
28073,1050,152,127,13,32,1374
28075,5579,1893,594,214,771,9051
28080,553,178,0,22,100,853
28093,701,209,15,23,71,1019
28096,176,55,71,4,13,319
28100,1243,399,338,39,458,2477
28103,1371,18,14,18,29,1450
28111,512,102,26,1,37,678
28114,979,435,244,60,163,1881
28124,1386,21,286,40,557,2290
28125,1096,89,0,9,23,1217
28126,707,209,0,5,198,1119
28128,655,128,0,11,208,1002
28130,3461,28,243,15,572,4319
28131,5,0,2,0,0,7
28132,917,4,0,19,173,1113
28133,302,2,0,1,209,514
28134,1825,5,305,4,60,2199
28135,542,0,0,0,4,546
28136,903,2,0,4,60,969
28137,342,42,139,11,43,577
28138,817,5,0,1,75,898
28139,73,0,0,0,4,77
28140,1558,13,143,2,146,1862
28141,1744,33,431,30,439,2677
28142,2644,79,0,56,702,3481
28144,807,4,0,0,41,852
28145,1751,41,0,2,36,1830
28146,5523,220,557,204,2956,9460
28153,2693,25,143,32,444,3337
28154,1827,20,0,39,663,2549
28156,239,42,143,15,9,448
28158,3800,47,341,55,713,4956
28159,45,28,24,0,1,98
28162,644,4,141,7,240,1036
28163,960,42,0,23,621,1646
28165,5722,185,143,49,585,6684
28166,2030,14,361,12,101,2518
28169,3112,28,2,21,580,3743
28171,3156,396,0,53,667,4272
28172,712,0,0,0,66,778
28173,1839,33,0,25,338,2235
28178,1913,68,429,34,891,3335
2818,0,0,0,0,0,0
28181,490,12,0,10,232,744
28183,1543,139,144,10,296,2132
28186,5025,307,0,267,3980,9579
28187,1062,33,0,33,523,1651
28191,407,13,0,0,42,462
28194,722,28,0,8,277,1035
28195,1959,14,143,54,92,2262
28198,2350,5,11,8,144,2518
28201,9619,32,568,53,1237,11509
28202,12435,92,855,199,4552,18133
28204,875,1,0,1,306,1183
28205,2366,5,0,3,84,2458
28207,946,12,0,16,252,1226
28208,2257,24,10,28,216,2535
28209,806,2,0,48,124,980
28210,3978,853,430,92,1078,6431
28211,815,23,0,18,421,1277
28212,1356,8,0,1,250,1615
28218,1641,6,0,19,85,1751
28219,2340,153,0,45,366,2904
28223,806,10,0,2,124,942
28224,1624,17,282,18,284,2225
28226,5013,111,853,127,1180,7284
28227,1066,11,0,3,48,1128
28229,1761,5,0,2,200,1968
28233,988,231,0,6,235,1460
28234,843,2,0,4,57,906
28235,1834,71,0,58,1183,3146
28236,847,3,0,5,227,1082
28238,793,4,0,0,40,837
28241,782,10,0,14,83,889
28242,620,0,0,1,25,646
28244,1162,120,6,29,147,1464
28245,2491,37,145,26,376,3075
28250,3375,32,0,12,153,3572
28251,908,5,0,0,149,1062
28254,1285,7,143,0,158,1593
28255,1212,51,289,16,121,1689
28258,6488,1102,709,126,1667,10092
28260,1869,501,0,36,676,3082
28262,824,9,0,12,15,860
28263,3043,63,419,36,570,4131
28265,3524,10,288,19,559,4400
28266,121,0,0,4,14,139
28267,1751,2,0,11,113,1877
28269,228,7,0,1,3,239
28271,1024,121,0,25,198,1368
28272,713,2,0,0,20,735
28276,294,24,0,8,3,329
28277,1310,12,0,1,157,1480
28279,3258,17,0,38,451,3764
2828,5233,421,174,38,692,6558
28280,3302,9,0,6,405,3722
28283,4441,141,285,77,1664,6608
28284,1595,44,287,38,651,2615
28285,1985,8,0,7,77,2077
28287,3606,14,285,45,630,4580
28288,3938,11,0,8,374,4331
28292,3416,22,143,18,501,4100
28293,995,1,0,5,43,1044
28294,3723,24,144,42,884,4817
28296,293,3,4,1,4,305
2830,0,0,0,0,0,0
28300,1616,154,0,32,198,2000
28305,1903,22,150,11,781,2867
28306,3394,52,0,31,933,4410
28307,1343,3,0,0,63,1409
28309,3141,44,0,48,545,3778
28318,324,131,144,1,37,637
28322,447,28,0,0,40,515
28323,809,98,143,1,12,1063
28326,1110,21,143,35,386,1695
28327,1381,28,0,17,64,1490
28328,794,196,0,30,83,1103
28329,5928,87,0,100,1648,7763
28330,2002,43,371,12,149,2577
28331,7652,114,853,123,2351,11093
28333,972,14,0,11,113,1110
28334,2298,3,0,13,150,2464
28335,745,3,0,4,148,900
28337,202,0,0,0,3,205
28338,550,174,0,29,277,1030
28340,1701,6,0,4,87,1798
28341,744,4,0,6,147,901
28342,861,140,0,46,117,1164
28343,27366,627,2440,313,4706,35452
28347,454,4,0,3,61,522
28348,1015,8,0,2,266,1291
28349,5714,32,143,69,950,6908
28352,1943,9,165,4,372,2493
28358,1136,65,0,43,425,1669
28359,5165,52,144,37,1566,6964
28360,2984,10,0,13,366,3373
28362,1954,4,143,1,226,2328
28366,889,42,143,8,25,1107
28370,1686,1,0,1,131,1819
2840,655,1,125,2,103,886
28419,0,0,0,0,0,0
28431,0,0,0,0,0,0
28469,0,0,0,0,0,0
2847,2226,93,230,2,200,2751
2850,538,3,0,0,3,544
28502,0,0,139,0,0,139
28509,0,0,135,9,0,144
28512,0,0,0,0,0,0
2852,0,0,153,0,122,275
28539,0,0,0,0,0,0
2854,207,72,2,1,0,282
28554,0,1,81,14,0,96
28555,0,0,139,1,0,140
2856,2908,0,617,3,166,3694
2857,1628,10,0,0,64,1702
28571,2757,68,301,3,486,3615
28573,356127,26327,7288,3449,47807,440998
28576,954,8,0,16,31,1009
28577,1045,8,0,7,162,1222
28580,3416,87,450,30,442,4425
28586,14,0,0,1,0,15
28587,197,0,0,0,13,210
28590,2121,47,414,14,575,3171
28591,984,2,0,1,9,996
28592,444,9,0,1,25,479
28594,837,81,38,13,1,970
28599,707,0,0,1,37,745
2860,385,0,27,4,464,880
28602,201,36,28,4,1,270
28604,31,26,144,0,0,201
28605,1949,11,0,11,22,1993
28606,1235,15,144,24,163,1581
28613,90,2,139,0,19,250
28615,559,1,32,4,48,644
28616,274,1,0,5,6,286
28618,3066,11,285,24,278,3664
28620,1605,4,141,16,273,2039
28621,453,3,0,1,79,536
28624,1076,3,0,5,259,1343
28634,5450,249,141,25,438,6303
28635,2063,115,425,63,276,2942
28636,1342,4,0,8,241,1595
28637,1469,16,0,18,44,1547
28638,769,9,0,9,139,926
28639,1056,5,0,17,126,1204
28640,1435,3,100,3,173,1714
28642,2211,22,0,35,592,2860
28644,1952,105,186,10,80,2333
28647,2547,47,0,19,314,2927
28649,14765,100,760,112,2057,17794
28652,171,1,0,4,13,189
28653,406,64,141,23,17,651
28654,1531,3,141,9,268,1952
28656,1300,184,0,66,571,2121
28657,1679,6,50,14,173,1922
28658,2195,137,144,9,329,2814
28665,81,28,0,0,1,110
28666,587,9,0,23,270,889
28667,2446,4,0,21,265,2736
28668,165,0,0,0,0,165
28669,11240,776,714,275,3321,16326
28670,1603,18,283,10,71,1985
28676,1158,9,296,14,18,1495
28682,0,0,15,0,0,15
28685,0,0,150,0,0,150
28716,4808,193,361,15,768,6145
28717,0,0,125,0,0,125
28725,0,0,102,6,46,154
2875,269,7,94,0,0,370
28753,0,0,0,0,0,0
28760,1767,9,38,0,30,1844
28761,0,9,58,1,0,68
28797,0,0,2,0,0,2
28812,0,0,0,0,0,0
2882,0,0,0,0,0,0
28840,1,7,117,1,0,126
28843,966,15,133,0,310,1424
28847,1354,28,76,5,342,1805
28849,67,0,15,0,1,83
28851,0,0,115,1,26,142
28854,2777,218,193,14,439,3641
28876,2025,24,298,20,147,2514
28878,0,0,260,0,0,260
28884,0,60,4,1,0,65
28905,0,0,0,0,0,0
28909,0,0,6,3,154,163
28917,75,6,6,0,0,87
28919,456,1,6,0,16,479
28929,3459,21,708,1,95,4284
28941,838,5,53,2,120,1018
28952,0,0,158,4,30,192
28954,950,3,4,0,173,1130
28964,140,0,8,0,278,426
2897,0,0,0,0,0,0
28972,0,0,17,13,18,48
28977,14,2,2,0,0,18
28999,1481,359,41,1,641,2523
29,0,0,0,1,0,1
2900,0,0,0,0,0,0
2902,0,0,0,0,0,0
2903,0,25,0,0,0,25
29030,71,0,12,0,185,268
29031,0,1,0,0,0,1
29050,1497,12,206,0,74,1789
29056,1344,58,172,0,7,1581
29066,1,0,0,1,0,2
29069,0,1,0,0,0,1
2907,25170,419,460,32,1023,27104
29075,205,0,0,0,0,205
29076,0,12,11,0,0,23
29081,797,5,267,0,4,1073
29084,159,0,75,0,263,497
29119,31,0,241,3,161,436
29124,0,33,109,9,0,151
29129,0,0,9,0,0,9
2914,749,194,2,25,225,1195
29170,0,0,121,31,572,724
29177,2059,38,58,21,223,2399
29182,290,18,116,12,28,464
29194,34,56,53,1,0,144
29208,138,1,702,3,129,973
29226,0,118,34,1,15,168
29238,1051,116,377,4,209,1757
29244,0,0,21,1,516,538
29247,812,1,0,0,146,959
29252,1766,34,17,6,100,1923
29256,260,0,26,0,140,426
29259,1,0,0,0,68,69
29286,3422,8,289,4,214,3937
29287,1906,127,12,5,332,2382
29300,1943,30,457,7,288,2725
29314,0,0,0,0,0,0
29319,0,1,0,0,0,1
29321,0,0,82,0,20,102
29329,0,1,0,0,0,1
29337,1,0,0,0,0,1
2939,0,0,0,0,0,0
29396,0,0,156,0,0,156
29405,0,0,113,0,0,113
29413,80,0,95,5,95,275
29414,0,0,0,0,0,0
29422,1764,24,132,2,9,1931
29447,6,0,0,0,4,10
29449,1122,31,137,0,340,1630
29456,0,26,38,0,0,64
29462,0,0,0,0,0,0
29468,1771,59,161,4,161,2156
29470,0,5,0,1,0,6
29484,990,1,192,0,61,1244
29485,1038,0,281,1,5,1325
29492,3481,139,257,16,1421,5314
29497,0,5,0,0,0,5
29518,7647,432,1294,26,4890,14289
29545,335,0,28,0,11,374
29580,222,0,544,17,1932,2715
29582,0,0,54,0,153,207
29596,0,4,36,0,0,40
29600,1940,90,393,7,1146,3576
29632,0,0,0,0,0,0
29644,1061,10,93,1,128,1293
29648,243,6,4,0,0,253
29664,0,0,0,0,0,0
29667,0,0,93,0,285,378
29672,396,0,2,0,12,410
29680,0,0,6,0,1,7
29687,0,0,9,0,74,83
29695,23966,519,1635,98,8867,35085
297,40,0,0,0,0,40
29706,0,0,0,0,0,0
29709,0,0,0,0,0,0
29713,95,0,0,0,5,100
29734,0,0,0,0,0,0
29736,1,0,0,0,0,1
29760,0,0,0,0,0,0
29774,307,17,129,6,94,553
29802,207,1,0,7,8,223
29804,0,0,0,0,0,0
29831,0,0,0,0,0,0
29838,12,0,0,0,0,12
29842,0,0,0,0,0,0
29843,0,0,0,0,0,0
29844,1105,0,0,0,0,1105
29852,0,0,4,0,0,4
29854,295,1,0,20,0,316
29866,0,0,0,0,0,0
29867,0,0,0,0,0,0
29876,1332,30,249,21,404,2036
29886,392,1,164,0,282,839
29894,1,0,0,0,0,1
299,0,0,10,0,0,10
29900,0,0,0,0,0,0
29914,0,0,0,0,0,0
29930,287,1,19,0,0,307
29933,64,0,0,0,0,64
29941,0,0,0,0,0,0
29953,2095,57,2,5,271,2430
29968,250,1,227,1,0,479
29979,2653,532,629,22,1719,5555
29994,0,0,57,0,0,57
3,0,0,23,0,0,23
30029,0,0,0,0,0,0
30032,0,0,0,0,0,0
30035,0,0,96,0,0,96
30036,0,0,0,0,0,0
30041,429,0,36,2,20,487
30045,0,0,0,0,0,0
30055,0,0,0,0,0,0
30072,0,0,0,0,0,0
30075,137,0,0,0,0,137
30083,0,0,0,0,0,0
30091,0,0,0,0,0,0
30110,2939,68,14,5,854,3880
30119,0,0,0,0,0,0
30162,0,0,0,0,0,0
30164,0,0,0,0,0,0
30165,0,0,0,0,0,0
30167,0,0,0,0,0,0
30170,1520,419,272,15,496,2722
30174,0,0,0,0,0,0
30182,0,0,0,0,0,0
302,0,0,0,0,0,0
30200,0,0,0,0,0,0
30220,0,0,0,0,0,0
30221,0,0,0,0,0,0
30236,2457,13,56,0,376,2902
30247,1205,0,0,0,0,1205
30257,0,0,0,0,0,0
30263,1245,8,2,2,65,1322
30264,0,0,0,0,0,0
30269,0,0,0,0,0,0
30290,0,0,0,0,0,0
30298,0,0,0,0,0,0
30325,0,0,0,0,0,0
30336,1735,9,50,0,94,1888
30341,0,0,0,0,0,0
30396,0,0,0,0,0,0
30404,0,0,0,0,0,0
30405,0,0,0,0,0,0
30408,0,0,0,0,0,0
30432,2475,14,32,19,478,3018
30444,0,0,0,0,0,0
30449,256,7,0,1,0,264
30459,0,0,0,0,0,0
30462,0,0,0,0,0,0
30466,6571,10,298,0,2645,9524
30481,0,0,168,7,0,175
30496,0,0,0,0,0,0
30499,0,0,0,0,0,0
30500,823,5,48,2,162,1040
30517,0,0,0,0,0,0
30536,0,0,0,0,0,0
30569,0,0,0,0,0,0
30600,0,0,0,0,0,0
30612,0,0,0,0,0,0
30633,2551,99,4,18,425,3097
30640,3198,246,70,24,481,4019
30666,1,0,68,1,0,70
30674,0,0,0,0,0,0
30676,0,0,0,0,0,0
30681,0,0,0,0,0,0
30688,0,0,0,0,0,0
30703,0,0,0,0,0,0
30709,0,0,0,0,0,0
30710,0,0,0,0,0,0
30722,70069,2953,5385,126,9906,88439
30733,0,20,2,3,0,25
30742,918,9,50,5,73,1055
30745,0,0,36,0,0,36
30764,87,0,264,4,82,437
30766,1113,4,261,1,7,1386
30781,0,0,110,0,35,145
30784,0,0,9,0,0,9
30801,1127,1,6,0,9,1143
30822,0,0,0,1,0,1
30823,743,2,0,4,226,975
30833,0,16,4,0,0,20
30838,517,5,77,0,83,682
30848,14474,1054,1283,61,813,17685
30877,0,12,0,0,0,12
30881,0,1,15,0,0,16
30900,800,21,66,1,208,1096
30922,0,128,98,0,0,226
30925,0,0,88,0,0,88
30981,12,0,0,0,1,13
31,0,0,0,0,0,0
31012,6651,63,345,7,277,7343
31027,40,0,265,0,0,305
31028,0,143,174,1,106,424
31029,0,0,59,0,187,246
31034,2912,15,543,106,625,4201
31042,0,0,400,13,630,1043
31059,0,27,42,0,0,69
31102,22,0,11,0,1,34
31115,4519,169,423,7,967,6085
31117,5,0,334,1,179,519
3112,0,0,0,0,0,0
31122,7675,974,872,9,2783,12313
31124,0,0,0,0,34,34
31127,0,0,110,0,6,116
31133,119,121,364,0,2,606
31143,562,7,134,0,39,742
31163,0,5,0,0,0,5
31167,85,0,118,0,8,211
31169,1950,9,177,2,204,2342
31204,174,0,63,2,87,326
31205,0,158,15,4,0,177
31213,0,0,0,0,0,0
31214,414,95,57,0,0,566
31225,185,0,0,0,0,185
31242,0,0,0,0,0,0
31245,100,0,4,0,1,105
31246,498,0,167,2,48,715
31250,0,0,111,0,135,246
31252,0,0,419,0,0,419
31261,0,5,0,0,0,5
31263,8050,187,546,23,1040,9846
31264,634,6,321,10,58,1029
3128,0,0,0,0,0,0
31286,9,44,17,0,0,70
31287,0,0,80,0,146,226
3131,23,0,4,0,0,27
31313,1446,30,308,2,46,1832
31317,1702,6,6,0,29,1743
31319,1118,232,114,2,125,1591
31323,0,6,11,0,0,17
31349,0,0,67,0,0,67
3136,0,0,0,0,0,0
31362,576,9,171,3,138,897
31363,96,7,9,0,0,112
31370,0,4,0,0,0,4
31376,0,17,75,0,0,92
31399,741,2,24,1,63,831
31420,0,0,78,0,0,78
31430,0,123,62,1,0,186
31435,0,0,0,0,123,123
31484,61,38,51,1,0,151
31495,177,5,0,0,9,191
31507,1954,8,224,0,78,2264
31510,2031,252,391,1,376,3051
31514,0,161,74,0,0,235
31543,0,0,32,4,124,160
31566,0,15,31,0,0,46
31581,1,0,2,0,0,3
31595,0,0,0,1,0,1
31615,0,0,247,0,0,247
31638,3356,67,443,17,137,4020
31642,1699,23,81,2,532,2337
31655,3,0,35,4,0,42
31662,0,0,0,0,0,0
31679,0,0,32,0,15,47
31720,0,1,27,0,0,28
31723,0,0,73,0,97,170
31724,0,0,8,0,0,8
31726,2949,48,280,2,340,3619
31727,0,0,0,0,0,0
31736,0,0,0,0,230,230
31758,0,0,0,0,0,0
31763,235,0,0,0,6,241
31775,0,0,23,1,0,24
31791,0,0,0,0,0,0
31822,60,1,6,0,0,67
31841,0,0,0,0,0,0
31849,0,0,0,0,0,0
31851,0,0,0,0,0,0
31857,1116,21,34,4,261,1436
31863,0,0,0,0,0,0
31875,0,0,0,0,0,0
31877,0,0,0,0,0,0
31898,3593,135,41,127,157,4053
31915,0,0,9,0,0,9
31920,0,0,0,0,0,0
31939,3736,370,570,112,1723,6511
31957,0,0,0,0,0,0
31967,0,0,0,0,0,0
31996,0,0,0,0,0,0
31998,554,18,27,2,142,743
32,179,0,22,9,0,210
32003,0,0,0,0,0,0
32020,112,3,455,7,0,577
32027,112,0,0,0,3,115
32034,0,0,0,0,0,0
32040,0,0,0,0,0,0
32071,0,0,0,0,0,0
3208,225,19,2,0,82,328
32083,74,2,33,2,2,113
3209,56064,1079,11760,163,14638,83704
32097,0,0,0,0,0,0
32098,4,0,139,4,0,147
32101,0,0,0,0,0,0
32104,0,0,0,0,0,0
3212,0,17,0,0,0,17
32123,305,0,0,0,18,323
32133,2278,12,218,58,893,3459
3214,95,0,4,0,0,99
32145,0,0,24,0,0,24
3215,77682,402,6368,66,6447,90965
3216,48,303,630,0,0,981
32160,0,0,2,0,0,2
32162,48,0,0,0,1,49
32181,18,0,0,1,2,21
32204,669,3,8,0,95,775
3221,1504,27,574,22,470,2597
32212,881,95,186,11,487,1660
32220,503,0,26,9,0,538
3223,10,0,0,0,2,12
32233,2871,51,39,2,1064,4027
32262,0,0,0,0,0,0
32264,0,0,0,0,0,0
32274,0,0,20,0,0,20
32277,10,0,0,0,0,10
32278,1,0,0,0,0,1
32307,0,0,0,0,0,0
32321,0,0,0,0,0,0
32329,5159,590,1228,187,2644,9808
32331,0,0,0,0,0,0
32354,1569,38,47,7,216,1877
32360,66,0,19,0,0,85
32363,0,0,0,0,0,0
32365,895,66,22,16,532,1531
3238,2097,7,87,11,559,2761
32391,0,0,0,0,0,0
32417,538,0,0,0,2,540
3243,44,0,172,0,204,420
32432,0,0,0,0,0,0
32440,0,0,0,0,0,0
32444,974,13,2,19,201,1209
3245,0,0,135,0,396,531
32458,0,0,0,0,0,0
3246,8276,389,1390,27,1037,11119
32475,0,0,0,0,0,0
3249,9758,202,1260,36,1526,12782
32490,534,7,30,1,50,622
32505,0,0,0,0,0,0
32508,193,0,11,0,0,204
32522,427,2,0,0,0,429
3253,0,0,0,0,0,0
32554,0,0,0,0,0,0
3257,5660,239,457,35,557,6948
32584,0,0,0,0,0,0
32592,149,0,0,0,0,149
32613,1154,207,10,22,525,1918
32614,501,31,13,0,37,582
3262,0,0,29,0,12,41
32624,0,0,0,0,0,0
32645,147,0,11,2,0,160
3265,0,0,397,0,0,397
32666,0,0,0,0,0,0
3267,204,0,0,0,0,204
3269,263407,4908,10933,314,18984,298546
32694,0,0,0,0,0,0
32703,1172,40,800,6,55,2073
32709,6,0,0,0,0,6
32726,79,0,0,1,2,82
32732,0,0,0,0,0,0
32751,9,0,0,0,30,39
32758,0,0,0,0,0,0
32765,0,0,0,0,0,0
32768,0,0,0,0,0,0
327712,1187,147,143,59,737,2273
32773,0,0,0,0,0,0
32780,263,1,0,20,0,284
32787,0,0,2,0,0,2
327931,2611,33,105,6,1671,4426
327934,301,18,315,25,241,900
32798,0,0,0,0,0,0
32800,0,0,0,0,0,0
32806,427,3,41,11,0,482
32808,1342,151,115,20,673,2301
32809,0,0,0,0,0,0
32829,0,0,6,0,0,6
32840,0,0,40,0,0,40
32845,0,0,0,0,0,0
32867,0,0,0,0,0,0
32883,0,0,0,0,0,0
32890,0,0,0,0,0,0
32899,4,0,0,0,0,4
32907,0,0,0,0,0,0
3292,15552,2582,1812,23,3175,23144
32934,0,0,0,0,0,0
32953,209,0,52,0,0,261
3300,84,0,0,3,2,89
33003,0,0,0,0,0,0
33007,0,0,8,1,0,9
3301,16527,1592,2248,127,12351,32845
3302,6091,93,573,24,316,7097
33029,0,0,0,0,0,0
3303,2692,0,2130,30,10555,15407
33038,0,0,0,0,0,0
33067,0,0,0,0,0,0
3308,5072,816,574,17,471,6950
33083,0,0,0,20,0,20
33084,542,3,0,1,27,573
33091,217,0,0,0,2,219
33097,0,0,0,0,0,0
33125,0,0,0,0,0,0
3313,1703,107,87,4,1022,2923
33130,0,0,0,0,0,0
33132,0,0,0,0,0,0
33133,0,0,0,0,0,0
33152,1742,78,172,34,910,2936
33154,566,9,0,1,26,602
33167,0,0,0,0,0,0
33176,0,0,0,0,0,0
33178,0,0,0,0,0,0
33182,109,5,0,10,0,124
3320,50364,22254,17225,1435,125707,216985
33218,0,0,0,0,0,0
33226,1,0,0,0,0,1
33230,685,1,12,1,0,699
33234,0,0,0,0,0,0
33247,0,0,2,2,0,4
33258,0,0,0,0,0,0
3327,389,9,112,6,17,533
33274,0,0,0,0,0,0
3329,963,0,388,1,2067,3419
33294,0,0,0,0,0,0
33307,0,0,22,1,0,23
33339,2769,9,0,1,190,2969
33346,0,0,0,0,0,0
33362,0,0,0,0,0,0
33363,2182,0,596,42,60,2880
33387,0,0,0,0,0,0
3339,1,0,0,0,6,7
33422,0,0,0,0,0,0
33438,105,34,0,4,37,180
33452,4,0,4,2,188,198
33470,721,19,12,4,247,1003
3348,0,0,0,1,2,3
33491,14,0,0,0,0,14
33501,374,27,84,1,245,731
33509,2092,7,59,10,276,2444
33515,0,0,0,0,0,0
3352,1224,0,851,19,2204,4298
33523,0,0,0,0,0,0
3354,0,0,0,0,0,0
33544,2982,289,152,17,648,4088
33548,2655,12,446,1,205,3319
33556,0,0,0,0,0,0
3356,24834,3428,3228,409,3854,35753
33576,0,0,0,0,0,0
33588,16611,1562,500,197,5874,24744
3359,381,0,0,0,2,383
33597,374,8,22,1,58,463
33604,1894,5,12,14,270,2195
33606,0,0,0,0,0,0
33616,5306,1,94,0,613,6014
33623,0,0,0,0,0,0
3363,3510,1,12,0,338,3861
33632,0,0,0,0,0,0
33638,0,0,0,0,0,0
33647,0,0,0,0,0,0
33651,365,12,0,1,2,380
33652,1,0,0,0,0,1
33657,367,0,0,0,0,367
33659,52,0,0,0,0,52
33661,0,0,0,0,0,0
33667,366,12,0,1,2,381
33668,1,0,0,0,0,1
3367,511,31,36,0,17,595
33670,0,0,0,0,0,0
33686,0,0,0,0,0,0
33701,0,0,0,0,0,0
33703,0,0,0,0,0,0
33725,0,0,0,0,0,0
33728,46,0,225,0,0,271
33734,0,0,0,0,0,0
33743,0,0,147,1,0,148
33748,0,0,0,0,0,0
33749,0,0,0,0,0,0
33779,806,44,171,1,631,1653
33796,334,66,33,0,181,614
33823,141,0,8,0,7,156
33835,1,0,20,0,0,21
33846,1,0,0,0,0,1
33874,1627,4,92,0,57,1780
3388,0,0,0,0,0,0
33883,0,0,11,0,9,20
33885,5877,119,1138,27,2181,9342
3389,0,0,0,0,0,0
33892,305,0,23,0,0,328
33901,1,0,0,0,0,1
33915,0,0,1879,0,1,1880
33916,0,0,92,0,0,92
33922,0,0,0,0,0,0
33943,0,0,169,3,27,199
33951,0,0,31,0,0,31
33977,1103,0,294,6,45,1448
33983,0,0,4,0,0,4
33991,81,0,0,0,0,81
33993,0,1,0,0,0,1
34001,529,13,0,0,239,781
34040,0,0,239,1,1,241
34060,256,1,0,1,8,266
34080,0,0,150,9,7,166
34086,677,2,270,0,2,951
34087,0,0,205,0,0,205
34093,0,0,79,0,27,106
34119,0,0,4,0,0,4
34123,125,86,151,0,0,362
34133,514,176,2,1,322,1015
34139,0,97,115,0,0,212
34156,32,0,4,0,0,36
34168,0,5,2,7,0,14
34177,1,0,0,0,1,2
34211,0,185,135,9,0,329
34219,25,0,76,0,0,101
34224,29,0,80,1,244,354
34244,9076,109,613,30,1199,11027
34245,3584,304,246,1,1061,5196
34263,0,11,0,0,0,11
34267,1,29,22,0,145,197
34295,0,0,100,1,315,416
34300,0,77,33,1,2,113
34304,254,0,64,0,3,321
34315,0,0,0,0,2,2
34318,0,0,15,0,140,155
34347,250,0,39,0,86,375
34354,607,56,138,18,496,1315
34362,18,0,80,0,0,98
34368,0,0,2,0,20,22
34373,0,0,0,0,0,0
34376,2,0,94,0,95,191
34383,0,0,2,0,0,2
34390,0,0,4,0,0,4
34391,0,0,48,0,0,48
34416,11,0,0,1,0,12
34421,6,1,15,0,0,22
34450,435,2,239,1,30,707
34456,0,195,34,0,0,229
3446,0,0,0,0,0,0
34467,18,2,53,0,0,73
3450,0,0,0,0,0,0
34518,78,0,0,0,0,78
3452,0,0,0,0,0,0
34524,0,0,162,0,61,223
34554,143,3,93,0,11,250
34555,0,0,41,1,0,42
34556,665,3,202,16,245,1131
3456,652,18,2,24,8,704
34560,461,0,9,0,14,484
34569,0,0,228,1,420,649
34577,331,0,215,0,218,764
34594,601,0,388,12,1567,2568
34602,0,89,66,0,90,245
34604,0,0,105,0,0,105
34606,4777,157,186,7,203,5330
34610,2828,23,288,4,627,3770
34612,0,0,0,0,0,0
34618,602,3,70,7,97,779
3462,115395,2780,4331,1560,2264,126330
34620,374,2,135,9,5,525
34622,576,72,87,2,248,985
34629,0,0,11,0,0,11
3464,0,0,0,0,0,0
34665,0,2,0,0,0,2
34694,2,0,2,0,24,28
34695,1383,18,119,1,17,1538
34705,2432,238,314,27,896,3907
34709,60,5,2,0,0,67
34723,354,37,21,0,13,425
34754,1,0,71,0,466,538
34758,4328,49,233,1,177,4788
3477,22,0,0,0,0,22
34779,218,0,393,9,56,676
34781,0,0,6,4,222,232
3479,0,0,0,0,0,0
3480,0,0,0,0,0,0
34820,0,0,64,0,0,64
34841,0,0,9,0,30,39
34858,185,0,4,0,0,189
34863,0,0,0,0,0,0
34878,597,0,0,0,2,599
34887,0,17,26,0,0,43
34892,19,8,0,0,0,27
3491,326,0,0,0,13,339
34912,2613,65,27,4,148,2857
34916,156,1,6,0,1,164
34917,0,0,41,0,44,85
34946,1103,3,223,11,93,1433
3495,21,0,0,0,0,21
34953,48,1,0,0,0,49
34955,0,0,0,0,0,0
34975,0,1,9,0,0,10
34977,0,0,0,0,0,0
34978,1094,2,46,6,23,1171
34985,29,0,0,0,44,73
34989,208,2,22,19,84,335
35000,0,2,123,0,0,125
35007,0,0,6,0,0,6
35046,0,0,8,1,1,10
35047,5022,149,451,21,847,6490
35048,0,0,27,0,0,27
35063,0,0,2,0,0,2
35066,398,5,63,4,73,543
35100,1475,58,322,26,372,2253
35110,6,1,58,1,0,66
3512,0,0,0,0,0,0
35122,0,0,2,0,52,54
35125,0,2,22,0,1,25
35132,5594,29,188,6,743,6560
35140,78,6,2,0,0,86
35141,0,0,336,7,970,1313
35154,0,0,92,0,0,92
35196,0,0,15,0,12,27
35203,53,0,0,0,1,54
35205,3525,12,449,0,445,4431
35214,0,0,23,0,14,37
35223,0,0,37,0,195,232
35224,0,0,33,0,0,33
35226,3648,184,333,2,311,4478
35228,0,0,0,0,0,0
35238,4,0,0,0,0,4
35239,0,27,65,0,0,92
35244,8880,32,730,24,1479,11145
35261,495,1,168,11,67,742
35267,188,1,12,0,18,219
35271,0,1,8,0,0,9
35328,264,0,63,2,35,364
35332,0,0,105,0,0,105
35348,322,2,165,13,31,533
35356,279,0,2,0,7,288
35361,0,0,9,0,48,57
35369,0,0,41,0,0,41
35370,93,2,136,0,4,235
35394,1,0,0,0,2,3
35401,0,1,0,0,0,1
35411,0,0,29,0,0,29
35415,0,0,137,0,0,137
35434,0,0,63,0,0,63
35441,65,0,0,0,5,70
35444,34,4,64,19,216,337
35448,28,0,6,1,13,48
35467,0,0,198,0,0,198
3549,11953,3326,2314,362,1394,19349
35493,0,0,2,0,0,2
35516,0,32,29,0,0,61
35518,0,0,40,0,619,659
35539,0,31,179,0,0,210
35540,68,0,22,1,0,91
35549,3336,76,166,20,108,3706
35567,1204,3,386,1,49,1643
35573,0,0,0,0,30,30
35575,15,0,0,0,0,15
35598,0,90,100,0,0,190
3561,250,18,0,7,2,277
35612,19173,814,2221,49,5258,27515
35613,1,0,30,0,1,32
35617,2430,33,303,10,377,3153
35621,0,0,6,0,31,37
35625,0,0,2,0,0,2
35632,0,0,0,0,0,0
35645,0,0,0,0,92,92
35664,288,0,76,0,6,370
35699,0,0,15,0,23,38
35706,3518,61,597,8,1356,5540
35725,1291,30,134,3,360,1818
35728,0,9,0,0,0,9
35765,0,0,4,0,16,20
35773,0,0,37,0,78,115
35790,1741,241,93,24,509,2608
35807,0,337,210,4,0,551
35810,0,6,69,0,0,75
35816,0,1,0,0,0,1
3582,176,0,0,0,14,190
35847,0,0,0,0,0,0
35860,13,0,0,0,0,13
35862,0,0,0,0,0,0
35871,0,0,0,0,0,0
35874,0,0,0,0,0,0
35891,216,0,28,3,0,247
35893,0,0,0,0,0,0
35894,0,0,0,0,0,0
35908,337,5,0,16,83,441
35911,13064,76,1004,25,2576,16745
35913,1695,75,23,62,959,2814
35916,7187,139,19,39,212,7596
3593,724,1,0,4,5,734
35971,0,0,0,0,0,0
35979,0,0,0,0,0,0
3598,204,0,0,0,0,204
35980,0,0,0,0,0,0
35985,0,0,222,8,0,230
35986,0,0,0,0,0,0
36001,0,0,0,0,0,0
36007,67,2,0,1,0,70
36012,1856,168,118,18,728,2888
36016,0,0,0,0,0,0
36019,0,0,0,0,0,0
3602,1450,235,30,4,131,1850
36063,443,1,26,0,6,476
36081,0,0,0,0,0,0
36086,0,0,0,0,0,0
36100,68,0,309,3,0,380
36103,1143,162,434,5,113,1857
36105,0,0,0,0,0,0
36114,0,0,0,1,0,1
3614,0,0,0,0,0,0
36143,1839,4,56,11,347,2257
36146,0,0,0,0,0,0
36180,95,0,2,0,2,99
36201,131,0,0,1,7,139
36207,0,0,0,0,0,0
36222,1206,20,74,8,333,1641
36223,4056,61,271,101,1137,5626
36236,221,0,0,1,2,224
36243,0,0,0,0,0,0
36269,0,0,0,0,0,0
36295,0,0,0,0,0,0
36305,0,0,0,0,0,0
36306,232,27,2,24,33,318
36316,0,0,19,8,0,27
36319,0,0,0,0,0,0
36327,0,0,0,0,0,0
3633,501,0,0,0,2,503
3634,0,0,0,0,0,0
36351,1519,262,8,63,212,2064
36352,234,2,0,9,87,332
36368,0,0,0,0,0,0
36374,0,0,0,0,0,0
36375,0,0,0,0,0,0
36384,1151,9,155,27,471,1813
36394,308,0,0,4,0,312
36436,0,0,0,0,0,0
36441,0,0,0,0,0,0
36443,0,0,0,0,0,0
36445,0,0,2,1,0,3
36487,0,0,0,0,0,0
36492,1100,133,217,11,653,2114
36498,0,0,0,0,0,0
36499,1090,75,239,7,435,1846
36515,0,0,0,0,0,0
36522,1268,2,0,17,110,1397
36534,18,0,0,0,0,18
36545,0,0,0,0,0,0
36556,0,0,0,0,0,0
3661,2998,18,112,0,165,3293
36610,0,0,0,0,0,0
3663,0,0,0,0,0,0
36647,0,0,0,0,0,0
36651,0,0,0,0,0,0
36666,626,17,0,9,395,1047
36687,1365,49,348,26,474,2262
36692,1,0,0,0,0,1
36695,0,0,0,0,0,0
36704,0,0,0,0,0,0
36715,0,0,0,1,0,1
36724,0,0,0,0,0,0
36728,0,0,0,0,0,0
36734,2375,274,134,9,677,3469
3676,0,0,0,0,0,0
36786,512,4,32,0,32,580
36794,0,0,0,0,0,0
36797,0,0,0,0,0,0
3681,0,0,0,0,0,0
36813,2,0,0,0,0,2
36817,3048,209,473,14,1328,5072
36827,0,0,0,0,0,0
36831,0,0,0,0,0,0
3685,0,1,0,0,0,1
36850,104,0,0,0,0,104
36947,156609,4199,2540,851,75853,240052
3695,0,0,9,0,0,9
3701,818,1,0,0,7,826
37100,0,0,2,0,54,56
3734,1621,5,0,0,27,1653
3737,27399,116,3426,159,4022,35122
3748,618,0,0,0,0,618
37492,33502,200,669,37,2641,37049
3758,10233,4509,952,135,2907,18736
376,2838,104,275,6,36,3259
37671,54,28,18,7,21,128
37693,126,51,531,5,214,927
37705,54,1053,1091,75,2587,4860
37717,647,111,91,41,65,955
37719,1,1,0,1,5,8
3778,0,0,0,0,0,0
3784,275,0,0,2,4,281
3786,52396,98,1349,25,1483,55351
37892,1321,50,18,0,152,1541
37908,1858,13,2,2,164,2039
37963,40211,88,737,43,267,41346
37970,245,0,0,0,0,245
37992,0,0,0,0,0,0
37997,0,9,0,0,0,9
38,0,0,0,0,0,0
38001,730,161,209,25,476,1601
3801,0,0,0,0,0,0
38019,664,0,2,0,61,727
38044,205,74,53,1,0,333
3807,275,5,0,2,27,309
38091,290,0,0,0,80,370
38092,195,0,0,0,0,195
38095,1642,1,25,0,1,1669
38096,1743,0,32,0,0,1775
38097,1050,0,2,0,0,1052
38103,2995,2,0,0,3,3000
38109,3578,2,24,0,4,3608
38120,3,0,0,0,4,7
38121,1,0,0,0,0,1
38123,13,0,0,0,0,13
3813,870,1,0,0,28,899
38133,1375,0,0,0,11,1386
38142,5,0,4,0,0,9
38143,636,107,141,29,224,1137
38144,15,21,24,5,0,65
38150,0,0,2,0,0,2
38153,0,0,0,0,1,1
38156,573,40,143,5,502,1263
38172,3901,2327,590,162,1667,8647
38182,0,119,0,0,0,119
38195,7355,1792,520,241,3414,13322
38197,472,0,11,2,26,511
38199,0,1,96,0,0,97
38207,1106,386,287,40,296,2115
38209,1084,236,254,4,179,1757
38220,333,22,0,0,130,485
38235,3801,31,606,20,570,5028
38247,2320,281,0,30,701,3332
38264,0,0,0,0,0,0
38266,15060,36116,512,3935,15585,71208
38278,0,13,0,0,0,13
38283,2399,30,132,0,46,2607
38285,768,1,0,0,253,1022
38296,28,0,0,0,0,28
38320,5742,1262,670,7,665,8346
38322,0,740,38,92,0,870
3833,0,0,0,0,0,0
38365,527,0,0,0,0,527
3839,534,0,70,0,10,614
38415,287,0,0,0,0,287
3842,492,15,0,10,106,623
38444,289,5,0,4,0,298
38450,447,49,129,2,20,647
38457,715,469,185,48,291,1708
38466,0,919,76,50,0,1045
38478,42,0,0,1,7,50
3848,1068,26,15,0,99,1208
38496,276,39,10,0,79,404
38500,77,11,0,1,7,96
38502,514,10,24,1,56,605
38505,77,1,0,0,1,79
38506,19,9,143,0,5,176
3851,922,24,0,4,129,1079
38511,9619,2522,411,143,3332,16027
38524,339,121,55,9,207,731
38526,138,1,0,0,1,140
38527,207,2,20,0,8,237
38529,105,4,2,1,9,121
3853,1398,23,41,6,432,1900
38532,647,93,13,13,309,1075
3855,1,0,300,10,0,311
38566,99,78,2,0,11,190
38623,7166,1677,1534,145,3752,14274
38628,5655,119,286,11,945,7016
38635,1,0,0,0,0,1
38661,643,1,10,11,6,671
38669,69,0,0,0,449,518
38673,82,0,0,0,1,83
38676,5,0,2,0,0,7
38680,822,0,8,0,5,835
38684,1024,0,0,0,0,1024
38690,0,0,0,0,0,0
38692,0,1,9,0,0,10
38700,76,0,0,0,0,76
38726,2088,4,452,10,299,2853
38731,595,295,0,11,119,1020
38732,308,0,6,4,48,366
38750,967,118,116,1,124,1326
38753,1216,162,4,4,283,1669
38758,5110,570,736,27,1137,7580
38764,1,9,0,0,0,10
38765,128,0,0,0,1,129
38766,358,66,103,0,75,602
38769,347,50,85,1,29,512
38771,288,147,144,21,265,865
38773,5,0,0,0,0,5
38776,152,0,0,0,5,157
38778,920,121,59,12,30,1142
38783,400,226,2,0,294,922
38785,774,285,143,1,398,1601
38790,2014,1276,269,42,1124,4725
38794,56,1206,265,46,0,1573
38809,1339,641,53,0,305,2338
38819,3704,4,63,36,807,4614
38835,3213,734,53,12,1035,5047
38841,6144,1022,367,698,154,8385
38843,21,0,0,1,0,22
38844,313,11,17,4,198,543
38845,57,0,0,0,0,57
38847,75,2,8,14,58,157
38851,1338,18,100,5,75,1536
38858,607,126,9,1,66,809
38868,0,2,2,1,0,5
38891,0,19,75,1,0,95
38896,1146,22,39,1,20,1228
38901,368,566,175,46,42,1197
38917,0,3,57,2,0,62
38919,0,0,31,0,0,31
38924,0,0,66,0,345,411
38932,0,0,0,3,47,50
38949,0,0,2,0,0,2
3900,0,0,0,0,0,0
39005,0,0,0,0,0,0
39007,1541,7,196,1,373,2118
39011,17,1,4,0,0,22
39013,0,0,15,0,205,220
39020,0,0,0,0,11,11
39024,0,0,44,0,169,213
39028,0,0,75,0,0,75
39045,0,2,283,0,0,285
39090,1436,2,16,4,64,1522
39093,1174,50,32,0,139,1395
39102,0,15,83,0,0,98
39120,2810,42,297,1,102,3252
39122,1169,18,37,0,113,1337
39135,0,0,128,0,16,144
39153,0,13,0,0,23,36
39155,0,0,4,1,0,5
39184,0,0,306,0,701,1007
39194,638,6,48,2,55,749
39235,18,0,28,0,14,60
39246,0,0,2,1,49,52
39248,0,0,0,0,0,0
39251,0,0,77,1,184,262
3926,0,0,0,0,0,0
39289,0,0,17,0,0,17
393227,0,0,0,0,0,0
393238,0,0,0,0,0,0
393240,0,0,0,0,0,0
393249,1424,8,8,0,241,1681
393251,0,0,0,0,0,0
39326,0,0,0,0,0,0
393273,0,0,0,0,0,0
393278,0,0,17,0,0,17
393301,774,0,75,1,129,979
393397,0,0,0,0,0,0
393429,0,0,0,0,0,0
393439,272,1,0,0,21,294
393442,15,0,0,0,0,15
393445,0,0,0,0,0,0
393455,0,0,0,0,0,0
393460,0,0,11,3,0,14
393467,0,0,0,0,0,0
393474,0,0,0,0,0,0
393508,734,28,87,10,318,1177
393524,0,0,0,0,0,0
393529,0,0,0,0,0,0
393552,2711,51,103,112,747,3724
393581,0,0,0,0,0,0
393591,438,10,41,1,76,566
393620,0,0,0,0,0,0
39365,652,10,0,1,115,778
393670,0,0,0,0,0,0
393686,439,20,0,1,92,552
39369,2498,19,185,0,344,3046
393706,934,143,221,16,175,1489
393713,4756,93,712,19,964,6544
393731,253,4,4,1,60,322
393740,0,0,0,0,0,0
39375,0,0,0,0,0,0
393759,0,0,0,0,0,0
39377,0,0,9,0,167,176
393775,0,0,0,0,0,0
393796,0,0,0,0,0,0
393809,0,0,0,0,0,0
393821,0,0,0,0,0,0
393844,0,0,0,0,0,0
393856,3708,38,336,47,477,4606
393885,0,0,0,0,0,0
393892,0,0,0,0,0,0
393916,0,0,0,0,0,0
393950,37,4,0,16,1,58
39396,0,0,8,0,11,19
393964,95,0,10,1,4,110
39401,0,0,4,0,354,358
39405,52,0,13,0,0,65
394065,103,1,4,2,1,111
394072,0,0,0,0,0,0
394111,3803,41,218,4,547,4613
394117,0,0,0,0,0,0
394141,0,0,0,0,0,0
394147,0,0,0,0,0,0
394195,0,0,0,0,0,0
394225,0,0,0,0,0,0
394232,709,1,4,4,83,801
394284,466,30,83,1,70,650
394285,0,0,0,0,0,0
394289,0,0,0,0,0,0
394326,905,4,96,5,216,1226
394330,0,0,0,0,0,0
394356,1,0,0,0,0,1
394380,0,0,0,0,0,0
394384,0,0,0,0,0,0
394391,115,2,0,0,3,120
394395,138,1,0,0,13,152
394399,0,0,0,0,0,0
39440,0,0,96,0,96,192
39441,1008,8,4,1,161,1182
394411,6,0,0,0,0,6
394437,0,0,0,0,0,0
394446,0,0,0,0,0,0
394449,324,4,11,0,47,386
394468,0,0,0,0,0,0
394472,0,0,0,0,0,0
394473,0,0,0,0,0,0
394474,0,0,0,0,0,0
39449,2033,208,117,1,1116,3475
394497,793,6,2,5,180,986
394534,0,0,0,0,0,0
394541,0,0,0,0,0,0
394548,0,0,90,18,1,109
394568,0,0,0,0,0,0
394579,0,0,0,0,0,0
394581,134,7,37,5,53,236
394607,0,0,0,0,0,0
39464,1319,14,401,6,264,2004
394666,0,0,0,0,0,0
394671,0,0,0,0,0,0
394695,685,1340,12,41,502,2580
394699,0,0,29,1,0,30
394708,9,0,28,0,0,37
394717,0,0,0,0,0,0
394740,0,0,0,0,0,0
39477,26,0,108,2,0,136
394778,0,0,0,0,0,0
394806,5,0,157,1,0,163
394830,0,0,4,4,0,8
394838,0,0,0,0,0,0
394859,0,0,0,0,0,0
394883,0,0,0,0,0,0
394897,0,0,0,0,0,0
394907,0,0,0,0,0,0
394911,0,0,0,0,0,0
39493,0,68,106,4,0,178
394972,22,0,26,0,83,131
394998,0,0,0,0,0,0
395040,0,0,0,0,0,0
39505,0,0,125,0,30,155
395073,0,0,0,0,0,0
395075,498,1,4,0,118,621
395087,2,0,0,0,0,2
395107,581,1,2,1,42,627
395111,0,0,0,0,0,0
395123,57,0,0,0,0,57
395127,0,0,0,0,0,0
395129,0,0,0,0,0,0
395139,0,0,0,0,0,0
39514,341,1,10,1,4,357
395148,0,0,4,1,0,5
395165,0,0,0,0,0,0
395167,685,20,134,24,442,1305
395172,0,0,0,0,0,0
395194,0,0,0,0,0,0
395209,686,1,192,0,52,931
395236,0,0,0,0,0,0
395245,0,0,0,0,0,0
395301,0,0,0,0,0,0
39531,734,18,150,5,103,1010
395341,582,4,24,0,138,748
395354,1986,1759,716,93,576,5130
395357,0,0,0,0,0,0
395379,0,0,0,0,0,0
395381,0,0,12,0,0,12
395399,1,0,0,0,0,1
395421,0,0,0,0,0,0
39543,2706,38,1079,44,190,4057
395437,40,0,0,0,0,40
395439,0,0,0,0,0,0
39544,0,0,0,6,158,164
39545,0,0,11,0,0,11
395461,0,0,0,0,0,0
395466,576,10,25,0,98,709
395478,66,1,0,0,1,68
395479,521,9,71,1,144,746
395500,148,0,4,1,6,159
395555,0,0,0,0,0,0
395582,0,0,0,0,0,0
395597,1,0,0,0,0,1
39560,445,1,8,0,0,454
395658,10,0,0,0,0,10
395662,0,0,0,0,0,0
395685,197,0,26,4,0,227
39569,480,3,30,4,34,551
395719,614,20,22,3,118,777
39572,1131,17,2,38,266,1454
39574,0,0,117,0,2,119
395748,70,2,526,29,0,627
395761,818,1,45,0,97,961
39578,0,0,0,0,156,156
395795,0,0,0,0,0,0
395810,0,0,0,0,0,0
395846,536,38,145,29,447,1195
395876,1751,123,956,61,501,3392
395922,0,0,115,1,0,116
395927,0,0,11,0,0,11
39593,0,6,64,0,0,70
395944,0,0,0,0,0,0
395948,0,0,0,0,0,0
395954,0,0,2,0,0,2
395965,1481,252,346,37,890,3006
39598,0,20,80,0,0,100
395993,0,0,0,0,0,0
396032,907,39,6,0,102,1054
396040,518,58,67,29,289,961
396052,0,0,0,0,0,0
396073,43,0,0,0,1,44
396087,629,2,0,2,42,675
396097,3391,212,55,95,1557,5310
396106,0,0,0,0,0,0
396107,0,0,0,0,0,0
39611,505,332,240,21,190,1288
396122,0,0,0,0,0,0
396125,756,5,61,0,134,956
396141,1309,11,32,6,73,1431
396168,0,0,4,0,0,4
396185,773,2,56,2,144,977
396190,36,0,0,0,3,39
396191,1300,0,0,0,0,1300
396226,0,0,40,7,0,47
396238,2,0,0,0,0,2
396253,37,1,0,1,1,40
396264,0,0,0,0,0,0
396287,0,0,0,0,0,0
396349,0,0,0,0,0,0
396356,277,191,9,5,92,574
396362,88,0,0,4,0,92
39642,13383,585,1140,30,1241,16379
396420,0,0,0,0,0,0
396422,0,0,0,0,0,0
396443,0,0,0,0,0,0
396461,0,0,0,0,0,0
39647,0,0,336,0,0,336
396472,951,25,6,4,345,1331
396481,80,0,0,1,8,89
39651,6723,130,831,17,4959,12660
396521,4,0,0,0,0,4
396536,223,0,0,0,0,223
39657,2956,217,229,52,668,4122
39686,0,0,0,0,0,0
396878,0,0,0,0,0,0
396905,0,0,71,0,0,71
396919,0,0,0,33,0,33
396948,1032,14,0,54,279,1379
396956,0,0,0,0,0,0
396982,737,6,0,11,93,847
396983,225,2,145,19,50,441
39699,3789,238,464,8,726,5225
396990,16,0,8,0,1,25
397005,627,0,0,4,145,776
397016,0,0,0,0,0,0
39702,670,7,265,13,6,961
397041,22,0,0,0,0,22
397044,0,0,0,0,0,0
397046,223,11,27,12,137,410
397048,63,0,0,0,0,63
397050,0,0,0,0,0,0
397068,0,0,0,0,0,0
397086,0,0,0,0,0,0
397092,0,0,0,0,0,0
397103,0,0,0,0,0,0
397122,0,0,0,0,0,0
397142,0,0,0,0,0,0
397156,56,0,0,3,5,64
397168,153,2,0,0,21,176
397268,481,25,61,0,296,863
39728,0,0,0,0,0,0
397285,1684,17,0,10,165,1876
397293,0,0,0,0,0,0
397298,0,0,0,0,0,0
397303,0,0,0,4,0,4
397305,0,0,0,0,0,0
397311,173,0,0,0,0,173
397324,0,0,0,0,0,0
397332,515,21,144,29,152,861
397347,0,0,0,0,0,0
397361,0,0,0,0,0,0
39737,2604,163,683,7,166,3623
397373,288,5,0,1,96,390
397376,85,0,0,0,1,86
397384,0,0,0,0,0,0
397394,0,0,17,1,0,18
397412,0,0,0,0,0,0
397422,709,29,54,21,299,1112
397423,320,4,0,2,277,603
397446,0,0,0,0,0,0
397453,0,0,0,0,0,0
397455,0,0,8,1,0,9
397484,166,1,66,1,31,265
397504,0,0,0,0,0,0
397545,3,0,0,0,0,3
397554,361,1,15,2,62,441
397569,861,13,4,20,155,1053
397606,170,13,4,4,36,227
397608,0,0,0,0,0,0
39761,0,0,22,0,16,38
397710,0,0,0,0,0,0
397712,312,1,0,4,75,392
397732,0,0,0,0,0,0
397745,0,0,0,0,0,0
397754,0,0,0,0,0,0
39777,331,17,0,0,2,350
397790,0,0,0,0,0,0
397797,0,0,0,0,0,0
397803,0,0,0,0,0,0
397833,0,0,0,0,0,0
397886,0,0,0,0,0,0
397893,0,0,0,0,0,0
397903,59,0,34,0,0,93
39791,0,0,198,0,2,200
397976,0,0,0,0,0,0
39798,35,0,0,2,6,43
398025,0,0,0,0,0,0
398050,5,0,0,0,0,5
398052,0,0,0,0,0,0
39808,436,2,0,0,29,467
398113,0,0,0,0,0,0
398135,0,0,0,0,0,0
398143,0,0,0,0,0,0
398156,0,0,0,0,0,0
398191,871,138,138,17,279,1443
398203,0,0,0,0,0,0
398210,0,0,0,0,0,0
398229,0,0,0,0,0,0
39823,0,0,0,0,0,0
398230,0,0,0,0,0,0
398232,0,0,11,0,0,11
398242,0,0,0,0,0,0
398256,0,0,92,0,0,92
39826,0,0,38,0,27,65
398297,0,0,0,0,0,0
398335,631,8,31,7,194,871
39835,34,0,4,0,2,40
398425,164,1,18,0,19,202
398451,0,0,0,0,0,0
39847,0,0,82,0,1,83
398496,0,0,0,0,0,0
398497,11,0,0,0,0,11
39857,0,0,125,0,0,125
398571,0,0,0,0,0,0
398700,116,1,0,0,11,128
398721,85,4,515,14,0,618
398754,0,0,0,0,0,0
398779,0,0,0,0,0,0
39878,437,0,88,0,1,526
39886,2061,4,0,0,14,2079
398940,0,0,0,0,0,0
399007,0,0,0,0,0,0
39904,0,0,20,0,0,20
39906,0,0,219,1,33,253
399079,147,1,6,1,13,168
399092,0,0,0,0,0,0
39912,1504,1,169,0,57,1731
39938,471,7,24,1,82,585
39939,7,0,0,0,0,7
39942,0,0,0,0,0,0
39948,0,0,269,0,0,269
39959,126,18,60,1,18,223
39961,41,0,0,0,1,42
39970,0,0,0,0,0,0
3999,312,0,56,0,8,376
39999,0,0,0,0,0,0
4,60,6,0,0,1,67
40020,0,0,0,0,0,0
40021,0,0,0,0,0,0
40029,3888,17,24,34,1063,5026
40033,248,2,0,0,13,263
40043,0,0,0,1,0,1
40050,279,0,0,0,0,279
40065,1314,1,0,10,93,1418
4007,286,9,0,0,194,489
40076,0,0,0,0,0,0
40082,0,0,0,0,0,0
40091,367,1,57,1,15,441
40098,1,0,0,0,0,1
4010,0,0,0,0,0,0
40108,864,5,19,6,4,898
40111,0,0,0,0,0,0
40121,0,0,0,0,0,0
40127,0,0,0,1,0,1
40128,2482,13,73,4,296,2868
40156,0,0,0,0,0,0
40181,0,0,0,0,0,0
40191,1469,43,174,0,123,1809
40197,0,0,0,0,0,0
40200,0,0,0,0,0,0
40224,280,71,281,2,49,683
40230,0,0,0,0,0,0
40232,0,0,0,0,0,0
40237,0,0,0,0,0,0
40244,0,0,0,22,0,22
40245,109,0,0,0,0,109
40246,0,0,0,0,0,0
40266,564,2,50,1,30,647
40281,770,2,113,0,69,954
40284,0,0,0,0,0,0
40285,6042,144,351,131,2129,8797
40311,664,30,405,29,4,1132
40317,0,0,0,0,0,0
40328,0,0,0,0,0,0
40335,0,0,154,1,0,155
40383,0,0,0,0,0,0
40389,0,0,0,0,0,0
40396,0,0,0,0,0,0
40405,0,0,0,0,0,0
40413,0,0,0,0,0,0
4043,629,57,82,1,359,1128
40468,445,0,0,3,4,452
40479,0,0,0,0,0,0
40510,0,0,0,0,0,0
40511,0,0,107,0,0,107
40523,1695,3,0,0,210,1908
40526,1,0,4,3,0,8
40536,0,0,0,0,0,0
40545,44,0,67,0,0,111
4058,8743,31,22,15,12,8823
40581,0,0,0,0,0,0
40586,0,0,0,0,0,0
40628,0,0,0,0,0,0
40641,300,4,24,1,38,367
40664,0,0,0,0,0,0
40676,1799,323,144,84,494,2844
40702,0,0,0,0,0,0
40703,0,0,0,0,19,19
40718,29,0,28,0,0,57
40727,500,30,80,1,196,807
40749,0,0,0,0,0,0
40772,964,7,221,4,357,1553
40773,0,0,4,0,0,4
40794,347,9,59,3,49,467
40805,121,0,0,1,0,122
40831,0,0,0,0,0,0
40837,0,0,0,0,0,0
40845,95,0,0,0,2,97
40861,4,0,0,7,0,11
40864,44,0,274,0,0,318
40866,0,0,0,0,0,0
40898,0,0,47,9,0,56
40910,0,0,0,0,0,0
40918,0,0,0,0,0,0
40926,0,0,0,0,0,0
40933,2106,56,125,0,400,2687
40948,0,0,0,0,0,0
40980,195,1,0,18,5,219
40993,0,59,47,0,0,106
41028,760,5,146,0,53,964
41034,0,6,39,0,0,45
41046,0,0,400,0,13,413
41088,0,0,2,0,10,12
41095,31,5,0,0,0,36
41105,1101,4,105,3,269,1482
41107,0,0,0,0,0,0
41109,0,0,11,0,0,11
41110,30,1,37,9,326,403
41114,2120,0,170,0,118,2408
41134,0,40,190,8,0,238
41160,588,5,46,6,37,682
41164,34784,195,1644,123,8783,45529
41230,26,0,8,0,0,34
41268,0,20,0,1,0,21
41272,0,0,0,0,1,1
41280,1,0,9,0,131,141
4130,599,0,0,0,26,625
41302,0,1,107,0,0,108
41307,311,0,75,8,236,630
41313,0,0,41,1,465,507
41327,967,143,169,0,301,1580
41330,228,1,2,0,8,239
41334,10,0,2,0,0,12
41336,121,2,0,0,0,123
41339,0,0,9,0,30,39
4134,1056781,73634,11502,895,17433,1160245
41378,508,18,11,47,95,679
41454,109,96,244,0,9,458
41491,1399,10,4,0,14,1427
41496,3305,1,192,3,248,3749
41497,2194,110,32,13,93,2442
4150,0,0,0,0,0,0
4152,0,0,0,0,0,0
41549,0,0,195,0,105,300
41557,228,0,509,6,700,1443
41563,424,12,10,1,333,780
41571,326,0,8,0,35,369
41575,0,27,0,0,0,27
4158,2534,0,10,1,67,2612
41585,1323,0,0,0,17,1340
41622,0,0,15,0,279,294
41624,9,0,78,0,2,89
41644,327,8,0,4,22,361
41668,0,84,103,1,0,188
41691,0,4,36,0,0,40
41709,0,1,0,0,0,1
41719,0,0,13,0,0,13
41727,0,0,13,1,0,14
41729,453,0,79,1,38,571
41733,1,100,93,3,0,197
41736,909,261,72,2,203,1447
41754,0,20,4,0,0,24
41782,0,0,74,0,1,75
41786,0,1,11,0,0,12
41802,0,16,0,0,0,16
4181,11508,337,167,86,2771,14869
41811,1,0,0,1,0,2
41827,168,0,2,0,22,192
41829,0,0,49,0,0,49
41858,456,0,10,0,5,471
41872,0,0,139,0,725,864
41897,3547,57,330,13,57,4004
41898,415,18,54,1,35,523
4190,104,0,0,0,0,104
4193,562,11,0,4,4,581
41931,0,0,17,0,0,17
41937,0,0,144,0,120,264
41946,0,0,2,0,0,2
41953,298,0,0,0,9,307
4196,0,0,0,0,0,0
41960,0,0,177,0,0,177
41972,0,0,0,0,0,0
41976,255,4,2,0,0,261
41989,0,0,0,1,5,6
41998,5955,8,322,8,161,6454
42000,0,0,6,2,16,24
4201,313,0,8,0,0,321
42010,0,0,0,0,0,0
4202,1,0,0,0,0,1
42049,1,0,2,1,33,37
42086,113,0,4,0,49,166
42090,1645,200,46,2,651,2544
42104,0,4,0,0,0,4
42116,0,27,0,0,0,27
42117,0,0,0,0,0,0
42132,0,56,71,0,0,127
42155,0,0,0,0,98,98
42159,0,0,0,0,0,0
42160,0,0,0,0,0,0
42175,0,0,0,0,0,0
42184,0,0,8,0,0,8
42187,0,0,0,0,0,0
42189,0,0,65,0,9,74
42227,571,61,70,0,222,924
42238,0,48,15,3,0,66
4224,0,0,0,0,0,0
42245,316,15,0,0,0,331
42248,0,0,262,3,350,615
42277,0,88,0,0,0,88
4230,29443,6771,3340,609,1168,41331
42306,0,0,247,9,25,281
42313,2535,101,428,16,976,4056
42318,1131,13,8,4,217,1373
42322,0,0,9,0,0,9
42343,1206,36,4,0,62,1308
42346,0,0,21,0,111,132
42351,0,0,148,0,75,223
42387,56,1,8,0,0,65
42405,539,1,79,0,2,621
42410,0,0,19,1,31,51
42425,401,1,34,7,28,471
42429,0,0,4,0,0,4
42431,0,0,24,1,166,191
42459,0,0,81,0,0,81
42473,1650,362,2,20,237,2271
42477,0,0,2,0,2,4
42487,27,0,0,0,0,27
4249,0,0,0,0,0,0
42517,0,0,0,0,0,0
42518,0,0,8,0,0,8
42525,0,0,98,0,0,98
42541,0,0,27,0,0,27
42555,0,0,102,6,487,595
4261,0,0,2,0,0,2
42610,7,473,433,16,77,1006
42625,0,0,2,0,40,42
42652,8552,272,305,29,1761,10919
42668,0,86,148,0,0,234
42669,802,43,107,0,76,1028
42682,0,31,8,0,0,39
42689,0,0,4,0,0,4
4270,356,130,0,12,9,507
42705,928,36,228,2,452,1646
42707,0,0,172,0,0,172
42708,2246,144,379,13,491,3273
42735,0,0,4,0,11,15
42772,7419,208,596,26,1896,10145
42794,0,0,0,0,136,136
42811,1,0,13,0,1,15
4282,0,0,17,0,0,17
42831,0,0,0,0,0,0
4284,0,0,0,0,0,0
42841,0,0,177,0,0,177
42844,0,0,76,0,0,76
42848,67,0,0,0,0,67
42863,0,0,17,0,89,106
42885,1413,13,19,0,128,1573
42893,0,109,67,0,0,176
42908,0,0,121,0,0,121
42947,0,0,9,0,4,13
42956,0,0,2,0,22,24
42965,1457,19,518,26,572,2592
42973,67,0,0,1,0,68
42998,0,11,81,0,0,92
43061,4,0,12,1,1,18
43068,0,0,0,0,31,31
4307,311,2,4,1,109,427
43070,0,0,0,0,0,0
43092,0,0,2,0,1,3
43094,69,8,144,7,19,247
4314,0,0,0,0,0,0
43160,0,0,0,0,0,0
43168,0,0,4,0,0,4
43192,911,176,15,6,601,1709
43205,0,0,874,0,2823,3697
43207,0,0,0,0,0,0
43232,2,0,0,1,0,3
43267,182,29,6,0,121,338
43284,0,0,0,0,41,41
43317,0,156,98,0,0,254
43341,4241,85,413,1,316,5056
43350,0,0,21,0,0,21
43364,392,0,40,1,4,437
43370,0,2,0,0,0,2
43372,0,0,0,0,0,0
43375,117,0,0,0,0,117
43402,0,0,0,0,1,1
43404,0,0,0,0,0,0
43406,1233,38,27,4,337,1639
43413,0,0,0,0,0,0
43443,935,33,161,1,52,1182
43451,0,0,6,0,13,19
43507,0,0,156,6,42,204
43513,2689,56,419,8,730,3902
43529,47,0,4,0,35,86
43542,0,0,17,1,3,21
43548,104,0,210,0,320,634
43557,11976,1004,1082,9,3601,17672
43561,703,0,757,55,1873,3388
43567,19,17,33,0,0,69
43568,1625,67,33,0,97,1822
43578,0,0,0,0,0,0
43599,1906,94,237,0,437,2674
43618,0,0,26,0,38,64
43624,0,0,0,0,0,0
43625,278,1,15,1,1,296
43648,227,6,142,2,45,422
43653,0,0,9,0,0,9
43660,0,18,98,0,0,116
43700,0,2,126,0,0,128
43708,0,4,48,0,19,71
43709,0,0,28,0,0,28
43714,0,41,33,0,0,74
43727,205,12,20,0,0,237
43734,34,1,0,0,5,40
43752,822,44,32,5,1,904
43782,241,0,0,0,0,241
43797,0,0,2,0,0,2
43803,0,0,110,0,0,110
43809,1539,3,99,0,144,1785
43843,1643,269,281,0,176,2369
43848,625,2,456,7,1,1091
4385,0,0,0,0,0,0
43865,0,33,22,0,0,55
43885,0,0,0,0,8,8
43905,1507,39,115,6,134,1801
43915,0,0,0,0,0,0
43922,368,0,19,0,11,398
43925,96,1,24,0,8,129
43940,3,0,229,11,582,825
43942,316,4,2,0,397,719
43959,0,0,0,1,1,2
43966,0,37,33,0,0,70
43989,1380,39,54,1,335,1809
43995,0,0,8,0,0,8
44002,0,0,2,0,1,3
44027,0,0,0,0,0,0
44030,0,5,0,0,0,5
44031,6,0,110,0,8,124
44034,5179,389,753,17,3172,9510
44050,0,127,94,0,0,221
44065,0,0,0,0,0,0
44066,2260,3,37,2,327,2629
44068,0,29,20,0,0,49
44070,0,0,0,0,1,1
44079,185,27,28,0,0,240
44081,221,0,0,0,35,256
44087,1258,21,68,0,65,1412
44092,2460,165,156,3,470,3254
44094,0,0,0,0,0,0
44134,0,0,8,0,0,8
44143,4,0,20,7,836,867
44180,0,0,0,0,0,0
44212,2813,741,539,27,1206,5326
44216,0,0,109,0,0,109
44219,1209,13,48,14,84,1368
44234,0,0,0,1,0,1
44247,0,0,2,0,106,108
44257,0,16,2,0,0,18
44265,0,17,18,0,0,35
44272,19,0,0,0,2,21
44277,465,3,194,1,34,697
44293,0,0,0,0,24,24
44306,148,0,74,3,1,226
44309,0,0,0,0,0,0
44313,0,0,0,0,78,78
44318,0,18,2,0,0,20
4434,110,10,0,0,28,148
44362,0,1,0,0,0,1
44365,0,0,0,5,53,58
44377,2203,20,52,8,209,2492
44380,0,2,6,0,0,8
44384,789,43,6,18,425,1281
44407,0,0,0,0,0,0
44430,0,0,11,0,0,11
44451,1618,13,15,0,247,1893
44452,0,0,11,0,2,13
44462,372,0,2,0,3,377
44466,0,0,0,0,8,8
44473,728,2,14,2,25,771
44483,551,1,43,8,303,906
44487,150,1,0,0,0,151
44489,150,0,145,0,59,354
44493,0,1,0,0,0,1
44494,0,0,0,0,0,0
44500,1,0,0,0,11,12
44506,1025,1,20,1,17,1064
44507,202,131,96,13,0,442
44512,2500,32,195,6,392,3125
44513,1590,3,55,0,142,1790
44525,0,0,0,0,23,23
44533,0,1,37,0,0,38
44539,0,16,0,0,0,16
4454,0,0,0,0,0,0
44598,0,0,83,0,0,83
44604,0,20,82,4,0,106
44619,72,20,0,0,0,92
44626,300,0,148,20,16,484
44631,0,0,102,0,21,123
44640,79,2,0,0,0,81
4466,0,0,0,0,0,0
44678,0,5,13,0,0,18
44682,491,0,143,0,8,642
44685,0,0,2,0,0,2
44705,31,2,0,0,0,33
44715,0,0,0,0,0,0
4473,0,0,0,0,0,0
44736,0,0,0,0,0,0
44741,146,0,9,0,6,161
44746,1144,1,75,1,30,1251
44747,1029,19,10,0,46,1104
44769,1786,28,240,2,488,2544
44787,1298,73,44,1,14,1430
44789,0,0,9,0,0,9
44814,0,0,120,2,200,322
44831,219,1,86,0,10,316
44843,0,0,0,1,0,1
44851,8,0,119,0,167,294
44869,0,111,423,0,0,534
44895,0,0,8,0,0,8
44901,0,0,44,6,46,96
44923,0,3,4,1,0,8
44927,16,0,11,0,0,27
44942,482,3,19,1,32,537
44943,0,0,22,0,0,22
44944,0,0,0,0,0,0
44967,0,0,72,0,30,102
4497,0,0,0,0,0,0
44974,982,2,137,7,71,1199
45,5,0,0,0,0,5
45007,0,0,114,1,132,247
45011,22526,278,2755,64,7630,33253
45013,0,1,143,0,0,144
45015,190,1,161,0,5,357
45025,283,9,0,0,0,292
45027,0,1,0,0,0,1
45061,14,1,0,0,0,15
45062,339,1,0,74,0,414
45090,21382,100,896,131,148,22657
45102,31670,1009,452,979,10903,45013
4511,0,0,0,0,0,0
45113,502,2,0,0,0,504
45117,10614,4368,5156,462,3280,23880
45143,2994,676,32,105,739,4546
4515,69034,1219,8307,320,10561,89441
45158,568,319,144,4,308,1343
45184,0,242,143,23,0,408
45187,1084,4,0,17,8,1113
45194,15228,4886,1917,578,4121,26730
45209,231,0,10,0,3,244
45243,260,6,0,0,2,268
45250,15,0,0,0,0,15
45267,227,17,0,0,3,247
45271,51034,32861,727,6347,33168,124137
4528,3660,24,141,0,150,3975
45284,0,346,240,50,0,636
45287,1406,214,89,2,573,2284
45288,264,10,119,0,20,413
45289,294,261,0,0,282,837
45292,40,11,13,0,1,65
45294,207,3,0,11,17,238
45295,279,84,17,0,91,471
45298,618,105,2,0,84,809
45302,44,70,2,0,8,124
45305,2251,746,577,61,1483,5118
45312,225,3,81,0,17,326
45313,216,42,0,0,65,323
45316,375,51,2,3,143,574
45317,67,5,104,0,48,224
45325,476,25,171,0,22,694
45344,0,0,0,0,0,0
45352,0,7,0,5,0,12
45361,0,0,0,0,6,6
45365,12,0,0,0,0,12
45374,829,0,0,0,3,832
45379,0,1,0,0,0,1
4538,30899,299,375,59,83,31715
45382,0,0,0,0,0,0
4540,6776,952,1542,93,4573,13936
45400,239,1,0,0,2,242
45410,27,316,78,5,2,428
45415,3267,2240,1555,230,1520,8812
45429,1283,186,363,27,230,2089
45430,19315,10199,855,781,8277,39427
45433,91,6,73,2,1,173
45447,572,155,0,22,246,995
45458,4396,1110,305,44,502,6357
4546,1,0,0,0,0,1
45469,230,69,9,2,8,318
45498,1309,794,156,31,346,2636
45510,1549,906,106,20,883,3464
45528,7221,1348,368,238,554,9729
45536,0,388,251,22,0,661
45539,1833,0,55,7,7,1902
45543,27027,185,1144,571,8004,36931
45557,2365,38,489,35,220,3147
45575,4,0,0,0,0,4
45582,125,770,255,68,0,1218
45594,835,111,132,14,373,1465
45609,13753,26222,1171,4862,12308,58316
45622,69,0,10,1,5,85
45629,10011,14677,1136,1359,8626,35809
45648,251,780,240,74,0,1345
45661,858,189,411,25,118,1601
45671,2323,321,73,18,578,3313
45677,1859,0,4,1,211,2075
45687,907,0,27,1,16,951
45694,1035,231,247,32,135,1680
45701,834,154,226,11,228,1453
45705,11,1,0,0,1,13
45706,1382,71,263,7,338,2061
45707,319,9,0,0,13,341
45716,427,11,131,4,20,593
45718,65,6,90,6,12,179
45722,351,19,45,4,48,467
45727,6844,3857,394,356,4772,16223
45731,87,8,85,0,17,197
45753,7163,2,379,210,428,8182
45754,5421,376,1685,113,2364,9959
45763,6785,996,250,106,2871,11008
45768,283,2,0,0,15,300
45769,8125,4297,686,546,2001,15655
45780,3170,1096,6,98,1119,5489
45786,1181,251,190,0,460,2082
45804,203,101,296,13,60,673
45806,208,13,0,0,0,221
4581,0,0,0,0,0,0
45820,3636,3150,394,111,138,7429
45839,0,197,12,37,0,246
45845,288,228,80,18,203,817
45884,245,68,13,17,34,377
4589,1,0,326,1,34,362
45896,522,1,0,14,1,538
45899,257134,3151,6137,6915,205128,478465
45903,21030,831,2827,239,2586,27513
45916,17651,11984,8130,1379,9288,48432
45918,68,0,0,0,4,72
4594,812,0,0,16,19,847
45942,1215,585,242,72,234,2348
45954,1317,302,633,63,277,2592
45960,286,472,138,30,0,926
45980,0,0,0,0,0,0
45996,15,0,0,4,1,20
46,0,0,0,0,0,0
46019,283,0,0,0,42,325
46023,2528,241,510,20,744,4043
46026,552,92,21,0,76,741
46028,370,9,51,2,43,475
46029,64,2,52,3,7,128
46032,619,107,13,3,81,823
46034,2,0,0,0,0,2
46044,29,2,0,1,0,32
46049,281,88,0,1,102,472
4605,1213,2,0,0,35,1250
46051,135,4,11,2,2,154
46054,47,11,0,0,2,60
46061,448,7,33,11,19,518
46063,83,1,74,1,2,161
4609,30643,386,3468,298,11045,45840
46093,0,0,0,0,0,0
46154,0,0,0,0,0,0
46158,0,1,25,0,0,26
4616,4491,0,11,1,403,4906
4618,3284,1038,291,77,706,5396
46188,0,0,130,12,0,142
46193,0,0,155,10,0,165
46208,0,0,61,0,0,61
4621,2296,882,228,20,206,3632
46231,0,0,0,0,0,0
46238,0,0,0,0,0,0
46253,0,0,0,0,0,0
46261,871,36,54,48,171,1180
46262,0,0,0,0,0,0
46273,259,0,0,3,0,262
46276,995,7,142,10,208,1362
4628,474,42,26,5,3,550
46281,0,0,0,0,0,0
46293,0,0,0,0,0,0
46300,0,0,0,0,0,0
46303,0,0,0,0,0,0
46315,0,0,0,0,0,0
46320,595,7,2,1,130,735
46328,0,0,0,0,0,0
46353,1181,185,99,22,332,1819
4637,2075,0,141,16,4,2236
46375,15883,922,284,41,3482,20612
46392,529,149,223,35,388,1324
46399,0,0,0,0,0,0
46426,0,0,54,0,0,54
46437,34,0,8,1,0,43
46449,0,0,0,0,0,0
46450,71,7,221,11,0,310
46475,0,0,0,0,0,0
46491,0,0,0,0,0,0
46494,0,0,0,0,0,0
46543,429,0,0,0,8,437
46562,767,18,0,21,292,1098
4657,7615,2153,579,232,3648,14227
46573,0,0,0,0,0,0
4658,329,2,189,1,12,533
46592,0,0,0,0,0,0
46595,0,0,32,1,0,33
46598,0,0,0,0,0,0
46606,0,0,0,0,0,0
46618,6158,60,555,0,2829,9602
4662,14606,176,401,263,66,15512
46620,0,0,0,0,0,0
46632,0,0,0,0,0,0
4665,411,0,0,0,0,411
4668,4,0,0,0,198,202
46685,0,0,52,1,0,53
46687,0,0,0,0,0,0
46690,293,0,318,0,0,611
46692,0,0,0,0,0,0
46694,0,0,0,0,0,0
4670,6,0,2,22,0,30
46719,0,0,0,0,0,0
4673,0,0,0,0,0,0
46749,0,0,24,1,0,25
4675,1,6,0,0,0,7
46760,0,0,0,0,0,0
4677,0,0,0,0,0,0
46780,0,0,0,0,0,0
46790,126,1,0,0,0,127
46792,0,0,0,0,0,0
4680,0,0,0,0,0,0
46811,0,0,0,0,0,0
46816,252,1,20,6,30,309
46817,0,0,0,0,0,0
46825,0,0,0,0,0,0
46826,968,32,207,18,441,1666
46841,0,0,0,0,0,0
46844,0,0,2,25,0,27
46849,0,0,0,0,0,0
4685,24516,3382,2014,277,5956,36145
46853,0,0,0,0,0,0
46855,51,1,9,1,24,86
46864,106,0,0,0,0,106
46867,544,3,126,18,160,851
46883,420,1,0,0,34,455
46886,1285,14,37,4,333,1673
46887,1611,33,1112,67,38,2861
46892,0,0,0,0,0,0
46906,0,0,0,0,0,0
46915,364,9,6,4,150,533
46920,168,1,29,0,52,250
46925,243,0,0,0,10,253
4694,1601,15,38,27,3,1684
46946,0,0,0,0,0,0
46957,0,0,0,0,0,0
46979,0,0,0,0,0,0
46986,0,0,0,0,0,0
47022,0,0,0,0,0,0
47028,0,0,0,0,0,0
47038,0,0,144,0,0,144
47054,0,0,78,5,0,83
47064,0,0,0,0,0,0
47066,42,1,0,3,5,51
47095,1,0,0,0,0,1
47096,0,0,0,0,0,0
47103,887,3,0,0,115,1005
4711,0,0,0,1,0,1
47114,0,0,134,0,0,134
4713,84410,16663,6351,478,18547,126449
47132,425,3,173,24,65,690
47155,549,4,28,10,35,626
47156,0,7,98,0,0,105
47164,0,0,0,0,1,1
47172,0,0,0,0,0,0
47178,503,3,113,0,19,638
47181,0,20,96,0,0,116
47187,1020,121,210,0,96,1447
47193,0,133,72,1,0,206
47206,0,0,0,0,0,0
4721,514,0,0,16,294,824
47217,3989,415,150,7,323,4884
47220,16,1,0,0,1,18
47232,0,0,77,2,15,94
47234,2383,186,559,51,1070,4249
47236,0,16,57,0,0,73
47241,273,6,0,0,0,279
4725,1294,34,137,24,28,1517
47283,0,1,0,0,0,1
47286,0,1,0,0,0,1
47297,1400,6,155,0,135,1696
4730,695,12,30,0,32,769
47321,0,58,45,0,0,103
47323,0,0,2,0,0,2
47349,0,0,0,1,0,1
47377,5,0,295,0,0,300
47388,31,0,0,0,0,31
4739,11443,3408,704,221,6929,22705
47394,3012,13,358,22,128,3533
47402,0,0,2,1,316,319
47406,588,1,83,0,25,697
47408,1755,62,109,7,488,2421
47438,0,27,2,3,0,32
47447,161,1,21,17,7,207
47453,0,0,0,0,1,1
47474,0,0,0,0,0,0
47493,0,0,21,4,2,27
47499,8,1,2,0,0,11
4750,442,2262,277,38,0,3019
47505,419,6,110,0,26,561
47516,342,1,239,0,75,657
47526,0,16,0,0,57,73
4755,4151,5992,737,116,79,11075
47562,0,47,34,0,0,81
47568,1189,11,187,3,109,1499
4758,0,0,76,0,0,76
47588,0,0,2,5,78,85
4760,126408,857,14287,1099,59575,202226
4761,7176,11237,345,649,6547,25954
47610,2841,10,35,0,327,3213
4764,12985,3772,1260,897,8522,27436
47655,0,2,0,0,0,2
4766,14937,129,360,273,13457,29156
4767,1112,299,138,24,510,2083
47680,972,453,108,4,281,1818
47692,341,0,0,0,43,384
4773,6009,2708,797,353,4101,13968
4775,31218,1723,7538,930,30626,72035
47759,0,20,8,0,0,28
47764,0,15,36,1,0,52
47771,0,0,122,16,203,341
4780,35179,496,924,477,570,37646
4782,421,1,13,1,0,436
47834,0,0,36,6,0,42
47849,68,0,8,0,130,206
4785,494,3,2,5,56,560
47869,0,0,0,0,0,0
4787,6327,3294,1199,155,3120,14095
4788,1813,158284,1871,3503,1442,166913
47881,0,0,4,0,228,232
47886,0,0,54,0,0,54
47902,1003,163,366,1,30,1563
4791,128,1,0,0,0,129
47913,0,0,0,0,16,16
47914,218,37,90,1,0,346
47917,20,0,0,0,0,20
47927,1828,32,272,8,138,2278
4793,6,0,0,0,0,6
47942,389,35,44,0,242,710
47949,0,0,0,0,0,0
4795,1924,81,10,21,727,2763
47954,0,30,11,0,0,41
47959,0,0,0,0,0,0
4796,313,12,0,0,26,351
4800,1499,51,54,0,97,1701
4802,2467,281,0,56,2605,5409
48024,450,2,0,28,41,521
4804,17231,3748,854,351,11100,33284
48063,5,0,0,0,0,5
4808,27117,1155,363,58,329,29022
4809,5528,559,12,14,41,6154
4812,82879,18790,1768,115,4081,107633
48124,0,0,9,0,0,9
48137,0,0,0,0,0,0
48146,4,0,2,4,46,56
48149,0,12,0,0,0,12
4816,1072,23,20,0,1,1116
48161,25680,92,2239,7,2981,30999
48166,0,56,99,0,0,155
4817,576,236,0,30,474,1316
4818,2,3439,107,223,0,3771
48181,0,0,18,0,75,93
48190,0,0,11,0,0,11
48233,0,0,155,0,244,399
48249,4,0,0,0,0,4
4826,3049,2377,329,38,1633,7426
48264,0,0,72,0,0,72
48265,118,0,148,0,5,271
48284,2404,11,20,13,116,2564
48293,0,36,31,0,0,67
48320,0,5,83,0,0,88
48326,0,0,0,0,0,0
48347,0,2,4,2,0,8
48348,0,0,0,0,0,0
48362,105,0,0,0,2,107
48364,0,0,0,4,0,4
48368,0,20,20,0,0,40
4837,416910,26096,683,457,3501,447647
4842,327,0,0,2,39,368
4844,573,193,92,1,344,1203
48452,0,0,2,0,19,21
48453,309,8,0,0,66,383
48467,0,2,0,0,0,2
4847,11265,233,72,12,644,12226
48474,9,0,17,1,1,28
48475,0,3,8,0,0,11
48500,2336,18,69,10,67,2500
48514,575,2,162,24,212,975
48515,0,0,0,0,0,0
48544,3792,47,254,13,597,4703
48564,400,6,139,1,23,569
48574,0,0,8,1,10,19
48584,0,0,80,1,184,265
48585,287,1,33,1,40,362
48602,0,0,78,4,0,82
48634,7,0,19,0,0,26
48635,0,0,13,0,0,13
48642,95,0,0,0,0,95
48661,0,0,21,0,5,26
48670,0,12,92,4,0,108
48698,0,0,0,3,24,27
48747,0,0,4,1,13,18
48758,0,0,17,0,0,17
48781,0,33,0,0,0,33
48803,3561,33,252,5,321,4172
48822,0,3,62,0,0,65
48832,0,0,133,1,1,135
48863,849,74,96,2,338,1359
48870,5,0,13,0,19,37
48904,1273,12,129,3,117,1534
48918,1136,1,304,0,110,1551
48926,39,0,6,0,16,61
48940,1,152,140,0,0,293
48945,0,0,42,0,125,167
48951,188,0,85,0,19,292
48960,0,0,42,0,0,42
48999,101,0,0,1,1,103
49000,0,0,69,0,0,69
49010,0,0,0,0,0,0
49040,0,0,0,0,31,31
49041,0,0,45,0,22,67
49052,976,3,224,0,156,1359
49060,0,0,0,0,0,0
49063,0,11,9,10,0,30
49088,1089,17,28,14,87,1235
49101,0,0,17,1,12,30
49106,20,19,23,0,2,64
49115,265,0,24,0,5,294
49117,0,0,15,7,1,23
49120,0,1,2,0,0,3
49122,0,0,6,0,29,35
4913,232,7,141,10,7,397
49170,0,0,0,0,0,0
49188,0,0,18,1,24,43
49214,244,0,0,0,2,246
4922,13538,406,2589,169,5909,22611
49221,474,39,4,15,225,757
49243,196,6,0,0,5,207
49261,0,28,13,0,0,41
49265,876,14,71,0,158,1119
49278,754,41,0,4,2,801
49289,1339,13,406,0,119,1877
49291,46,1,107,0,0,154
49320,29,137,18,0,0,184
49342,0,166,134,0,0,300
49346,0,0,11,0,0,11
49350,101,1,2,0,0,104
49360,1235,91,271,1,177,1775
49367,737,4,111,13,110,975
49368,133,212,99,0,0,444
49403,0,0,6,0,0,6
49419,681,2,106,1,59,849
4943,0,0,0,0,0,0
49439,260,0,0,0,0,260
49453,0,0,167,0,0,167
49455,1857,10,190,5,117,2179
49502,0,0,0,0,0,0
49505,0,52,66,6,0,124
49510,0,2,0,1,0,3
49524,2472,43,368,7,59,2949
49532,167,10,0,4,54,235
49535,266,1,13,0,22,302
4954,1,0,0,3,5,9
49544,0,0,338,0,0,338
49565,1,0,0,1,34,36
49567,1767,13,0,6,228,2014
49586,358,0,107,0,7,472
49597,170,0,0,8,14,192
49605,2288,88,103,0,140,2619
49629,0,0,0,0,0,0
49635,0,0,0,1,0,1
49641,0,13,0,0,0,13
49653,1141,14,182,0,116,1453
49709,329,1,0,0,2,332
49711,253,0,140,0,41,434
49719,170,3,0,1,5,179
49725,210,0,2,0,1,213
49757,0,0,0,0,0,0
49770,927,28,99,0,494,1548
49773,0,0,2,0,16,18
49774,242,45,14,18,11,330
49776,0,1,47,0,0,48
49777,0,1,15,0,0,16
49784,0,0,8,0,0,8
49798,0,0,8,0,16,24
49808,0,0,125,0,373,498
49816,0,12,0,0,0,12
49821,83,2,0,0,0,85
49826,1035,0,0,4,9,1048
4983,83,2,0,8,2,95
49849,359,0,19,0,222,600
4986,744,179,144,8,311,1386
49863,0,1,4,0,0,5
49864,0,0,6,0,6,12
49890,8,0,0,0,0,8
49893,0,8,0,0,0,8
49902,38,0,0,0,0,38
49909,622,0,9,6,9,646
49924,1227,12,164,1,98,1502
49931,62,0,100,0,0,162
4995,166,31,11,0,10,218
49956,632,5,107,12,106,862
49979,1120,145,190,11,307,1773
49981,0,0,77,0,0,77
49985,57,1,168,0,3,229
50009,0,2,6,0,0,8
50020,0,0,4,0,93,97
50045,20,0,0,0,0,20
50048,12,0,0,0,0,12
50050,0,0,107,0,0,107
5006,0,0,0,0,0,0
50060,114,160,102,1,0,377
50064,498,1,77,2,70,648
5008,0,0,0,0,0,0
5009,0,0,0,0,0,0
50092,0,0,8,0,0,8
50129,0,0,0,1,13,14
50147,0,0,0,0,0,0
50155,159,0,0,0,5,164
50163,0,0,6,0,0,6
50174,235,2,51,0,0,288
50186,0,0,6,0,19,25
50231,0,0,0,0,0,0
50241,0,9,4,0,0,13
50242,0,0,39,0,0,39
50245,0,0,0,0,0,0
50252,12,0,9,0,0,21
50266,0,0,246,0,0,246
50294,143,0,0,1,142,286
50299,0,0,0,0,0,0
50302,0,0,62,0,62,124
50304,2953,33,212,17,557,3772
50316,1628,7,431,2,108,2176
50334,479,181,127,2,163,952
50340,0,55,33,1,0,89
50349,0,0,2,0,0,2
50357,565,6,285,1,249,1106
50360,0,0,13,1,18,32
50368,0,0,0,0,26,26
50418,0,219,2,9,0,230
50427,278,1,0,0,0,279
50438,12,0,45,1,1,59
50449,0,37,0,0,0,37
50469,1768,5,36,2,42,1853
50473,0,175,6,1,0,182
50477,531,80,0,0,0,611
5048,751,0,2,0,49,802
5049,0,0,0,1,0,1
50498,63,0,9,1,0,73
5050,24,0,0,0,0,24
50522,0,0,4,0,0,4
50538,0,5,2,0,0,7
50542,0,59,101,4,0,164
50553,0,5,13,0,0,18
50554,0,0,2,0,0,2
5056,1,0,0,0,0,1
50577,0,0,2,0,0,2
50590,110,1,0,0,48,159
50593,21,0,2,5,4,32
50596,0,0,0,0,0,0
50604,598,9,293,0,264,1164
50616,573,2,81,2,122,780
50627,539,3,37,0,37,616
50629,28,1,8,0,1,38
50668,0,22,36,0,0,58
50672,0,127,117,0,0,244
50673,0,0,82,0,0,82
50682,400,2,0,1,75,478
50685,247,7,98,4,64,420
50698,0,2,59,0,5,66
50716,0,0,0,0,0,0
50718,33,0,0,0,1,34
5078,0,0,0,0,0,0
50780,0,1,0,0,0,1
50821,4779,48,694,31,812,6364
50825,0,0,0,0,0,0
50837,11,1,0,2,65,79
50852,41,4,96,0,0,141
50877,655,14,65,1,64,799
50886,581,0,0,0,16,597
50887,19,0,0,1,0,20
5089,3037,0,740,32,863,4672
50919,0,0,0,0,32,32
50925,0,0,0,1,0,1
50926,1,0,0,0,0,1
50929,19,0,0,0,24,43
50953,0,0,2,0,4,6
50971,0,0,0,0,2,2
50973,30,0,13,1,110,154
51001,158,1,11,0,6,176
51011,0,1,40,0,34,75
51024,76,0,144,0,18,238
51028,0,12,35,0,0,47
51042,0,0,0,0,0,0
51043,0,0,0,0,0,0
51052,369,0,0,0,278,647
51054,0,0,0,0,0,0
51070,0,0,2,0,0,2
51077,0,1,2,0,0,3
51088,0,0,0,0,0,0
51102,542,0,97,1,56,696
51132,2277,94,134,2,465,2972
51151,0,0,0,0,49,49
51167,14440,128,692,304,4424,19988
51173,815,88,35,3,342,1283
51184,0,0,0,0,0,0
51189,13,0,49,0,131,193
51207,379,0,39,6,7,431
51265,0,0,105,0,2,107
51300,733,13,44,3,243,1036
51333,34,0,0,0,1,35
51343,0,0,15,0,0,15
51395,0,0,0,0,17,17
51400,0,0,2,0,0,2
51402,0,0,11,0,20,31
51420,5,0,0,0,50,55
51430,953,7,21,10,436,1427
51451,0,0,0,0,8,8
51461,0,0,0,1,5,6
51487,6,0,0,0,164,170
51504,607,1,17,0,58,683
51524,0,0,11,0,1,12
51551,0,0,0,0,0,0
51561,37,0,68,4,0,109
51569,244,0,18,0,11,273
51570,0,25,17,0,8,50
51580,2022,69,288,12,113,2504
51582,0,0,84,1,287,372
51604,0,0,40,0,0,40
51615,683,0,253,1,15,952
51616,954,29,61,0,308,1352
51653,16,0,9,1,1,27
51656,0,0,0,0,0,0
51659,0,26,4,6,0,36
51660,0,0,2,0,0,2
51669,0,1,11,0,0,12
51685,0,0,0,0,0,0
51704,0,0,0,0,8,8
51725,0,39,114,0,0,153
51744,0,0,4,0,0,4
51747,1361,35,34,0,210,1640
51764,0,0,45,0,0,45
51799,588,2,16,2,165,773
51800,0,0,0,0,0,0
51812,0,16,11,0,0,27
51813,0,0,13,0,0,13
51815,2574,35,140,0,202,2951
51819,0,25,13,0,0,38
51852,0,0,0,17,68,85
51873,0,0,0,0,0,0
51874,0,0,0,0,0,0
51891,0,0,2,0,0,2
51947,0,0,83,0,12,95
51968,0,0,0,0,5,5
51972,0,0,0,0,0,0
51973,0,10,92,0,0,102
51978,606,37,120,1,46,810
52,0,0,2,0,0,2
52000,0,0,0,4,0,4
52026,0,0,6,0,70,76
52029,0,0,0,0,0,0
52030,564,5,35,0,124,728
52054,92,1,22,3,16,134
52075,0,0,22,0,0,22
52092,0,0,103,3,0,106
52115,0,0,12,0,0,12
52116,0,0,4,1,166,171
52157,1548,1,188,1,141,1879
52173,393,5,2,0,63,463
52175,0,0,17,0,0,17
52207,0,2,0,0,0,2
52232,3538,1135,331,269,871,6144
52235,171,86,96,12,38,403
52236,234,92,136,8,33,503
52251,2257,591,194,49,215,3306
52255,355,199,0,8,81,643
52259,321,180,144,20,64,729
52268,570,99,146,4,12,831
52271,665,366,146,23,153,1353
52273,214,108,0,4,28,354
52279,1267,513,147,67,239,2233
52280,305,107,90,12,110,624
52292,176,126,82,14,40,438
52295,41,1,0,0,1,43
52296,162,77,84,7,26,356
52300,149,80,2,0,41,272
52303,181,135,72,14,49,451
52307,812,424,144,52,96,1528
52308,2201,460,442,75,233,3411
52312,868,171,543,10,64,1656
52313,107,28,100,0,9,244
52317,2,18,0,0,2,22
52318,1,35,144,11,0,191
52322,324,230,4,23,106,687
52323,1533,625,0,55,209,2422
52327,1112,251,911,10,55,2339
52329,203,15,0,0,14,232
52339,1126,425,144,44,110,1849
52341,1108,307,0,59,267,1741
52348,343,114,103,8,25,593
52349,453,160,210,4,89,916
52350,176,63,0,11,27,277
52351,228,150,0,16,84,478
52352,374,316,97,52,156,995
52354,305,132,6,1,26,470
52361,1549,422,100,68,254,2393
52363,534,361,189,81,195,1360
52364,445,82,2,7,23,559
52367,502,75,146,15,106,844
52368,170,115,144,2,109,540
52369,946,129,179,26,79,1359
52371,160,92,0,10,31,293
52372,337,130,146,15,37,665
52373,218,96,0,5,58,377
52380,192,164,36,13,35,440
52381,588,295,0,70,101,1054
52383,173,8,0,0,2,183
52387,326,200,0,15,108,649
52388,146,49,0,11,14,220
52393,240,1,99,6,0,346
52397,56,76,0,8,1,141
52399,574,46,2,4,15,641
52401,166,71,131,12,30,410
52402,183,152,0,12,43,390
52405,643,106,22,9,26,806
52409,220,153,0,14,69,456
52413,180,128,0,11,62,381
52414,177,117,95,0,53,442
52419,966,318,0,49,116,1449
52420,520,255,0,46,119,940
52425,292,84,0,15,43,434
52426,521,62,399,4,28,1014
52428,518,202,89,15,80,904
52430,180,80,11,4,23,298
52431,311,26,6,4,14,361
52432,261,5,98,0,5,369
52435,187,73,0,2,86,348
52436,949,323,246,57,90,1665
52439,502,166,144,13,142,967
52444,1094,633,570,66,284,2647
52447,237,137,0,13,32,419
52453,137,93,35,7,40,312
52455,1055,2,15,0,6,1078
52459,1,0,0,0,0,1
52465,957,495,463,54,221,2190
52468,217,1,2,1,51,272
52473,221,22,0,0,11,254
52474,151,11,0,0,7,169
52475,252,118,0,20,107,497
52477,554,308,20,41,133,1056
52481,160,72,144,9,17,402
52484,81,16,0,1,1,99
52486,488,218,90,39,40,875
52489,1,1,0,0,0,2
52490,177,120,95,3,44,439
52491,161,51,0,4,10,226
52492,232,131,0,12,17,392
52493,411,119,114,18,75,737
52496,396,69,288,3,20,776
52498,163,38,0,5,7,213
52503,147,57,0,5,15,224
52505,173,116,99,6,50,444
52507,340,179,148,20,76,763
52510,446,104,143,18,70,781
52516,676,1,0,0,15,692
52519,289,6,69,1,18,383
52524,554,234,0,62,363,1213
52525,458,8,0,11,77,554
52527,1102,7,141,16,152,1418
52528,866,3,144,2,361,1376
52531,925,16,0,16,251,1208
52532,2794,57,159,56,822,3888
52537,1022,33,0,8,143,1206
52539,865,6,0,7,130,1008
52542,733,22,0,59,328,1142
52544,1859,7,12,3,231,2112
52545,1660,7,144,12,44,1867
52547,1504,23,287,18,215,2047
52548,778,17,0,12,118,925
52549,1202,18,0,18,219,1457
52551,147,8,0,4,13,172
52554,305,20,0,17,87,429
52557,456,1,0,0,107,564
52558,198,29,0,10,40,277
52559,579,142,0,18,135,874
52560,754,0,0,8,49,811
52561,621,7,0,12,89,729
52564,785,48,285,34,185,1337
52566,172,0,0,3,4,179
52567,106,0,0,0,2,108
52570,946,37,0,21,206,1210
52571,208,35,0,42,155,440
52573,1733,9,0,8,119,1869
52574,4,0,0,0,0,4
52575,225,3,0,4,3,235
52576,655,41,0,6,41,743
52577,521,8,0,10,236,775
52578,172,0,0,1,10,183
52579,787,18,235,2,75,1117
52583,2,0,0,1,0,3
52584,325,8,0,7,40,380
52587,331,3,0,5,33,372
52591,315,0,141,0,19,475
52592,238,11,0,3,117,369
52593,1008,3,114,10,159,1294
52596,598,1,0,4,77,680
52597,542,1,0,6,55,604
52599,1381,24,254,44,360,2063
52600,835,58,0,33,430,1356
52601,1291,143,0,28,222,1684
52602,398,1,0,10,151,560
52603,345,19,0,11,104,479
52604,780,4,0,5,258,1047
52606,476,0,0,1,2,479
52607,338,1,0,0,17,356
52610,1534,24,156,31,444,2189
52612,852,4,144,7,257,1264
52613,1840,79,143,81,881,3024
52614,274,2,0,1,94,371
52615,465,5,0,2,44,516
52616,360,0,161,0,80,601
52617,59,2,141,1,0,203
52625,514,11,0,15,115,655
52629,458,1,0,0,97,556
52630,1342,14,141,21,509,2027
52631,542,4,144,10,19,719
52633,421,0,0,0,48,469
52634,376,0,0,3,50,429
52637,440,122,0,38,188,788
52638,666,16,0,6,292,980
52642,380,7,0,12,34,433
52643,386,2,0,3,13,404
52644,419,10,0,7,77,513
52647,218,4,0,6,65,293
52650,1734,50,288,49,644,2765
52651,1309,1,158,5,229,1702
52653,1168,47,143,25,595,1978
52654,970,23,0,14,475,1482
52655,972,13,139,20,195,1339
52659,177,50,0,20,86,333
52660,232,91,0,9,37,369
52661,352,12,0,13,203,580
52662,707,184,0,32,117,1040
52663,840,34,0,19,293,1186
52664,1506,25,0,38,392,1961
52670,1028,1,0,1,127,1157
52673,536,22,0,15,145,718
52674,764,18,0,18,156,956
52675,577,7,0,38,198,820
52680,1019,3,0,18,41,1081
52685,900,1,0,0,33,934
52686,767,9,417,18,253,1464
52688,262,16,0,7,177,462
52689,842,185,263,19,200,1509
52692,1134,11,0,26,177,1348
52694,858,0,145,8,53,1064
52695,669,114,127,18,263,1191
52696,262,2,0,4,101,369
52697,880,2,0,10,253,1145
52698,547,8,0,6,47,608
52699,803,122,143,9,96,1173
52705,837,12,0,12,161,1022
52706,1409,3,134,1,29,1576
52708,821,23,144,1,108,1097
52712,1041,3,267,1,62,1374
52714,702,3,0,0,74,779
52715,378,1,0,1,8,388
52716,163,69,0,14,34,280
52717,1361,61,287,11,261,1981
52719,183,3,0,7,26,219
52720,691,148,141,5,171,1156
52722,780,3,0,1,47,831
52724,254,0,0,1,3,258
52726,1199,12,144,14,424,1793
52727,820,12,0,9,133,974
52731,435,47,0,1,125,608
52737,818,10,0,17,205,1050
52739,472,70,96,5,90,733
52741,267,40,144,10,15,476
52742,761,7,0,1,28,797
52743,349,0,0,8,14,371
52744,1099,5,0,11,159,1274
52745,872,7,0,12,37,928
52747,138,0,0,0,31,169
52748,1659,11,0,25,208,1903
52751,2896,15,283,31,353,3578
52752,810,1,0,3,57,871
52757,84,1,0,4,11,100
52758,1429,28,330,20,274,2081
52760,1030,6,16,16,276,1344
52762,556,0,0,2,70,628
52764,226,2,0,0,5,233
52765,784,18,0,22,134,958
52766,151,12,0,4,5,172
52767,413,13,0,19,179,624
52769,783,4,4,12,50,853
52772,243,49,0,34,98,424
52773,371,17,0,1,44,433
52774,504,14,0,9,144,671
52775,727,2,0,4,82,815
52778,226,61,0,5,74,366
52780,819,22,144,26,112,1123
52781,533,52,0,2,84,671
52783,1721,83,0,87,1076,2967
52786,739,23,0,22,404,1188
52787,376,11,0,10,113,510
52790,893,9,0,11,222,1135
52794,1012,222,285,51,350,1920
52795,453,31,0,5,14,503
52800,981,15,279,8,86,1369
52802,845,1,11,5,110,972
52803,264,2,0,0,12,278
52807,1847,8,144,4,135,2138
52809,622,3,0,9,119,753
52813,787,7,0,7,107,908
52814,747,2,0,6,66,821
52815,631,13,0,10,237,891
52817,1198,2,0,2,73,1275
52818,253,0,0,0,38,291
52821,353,0,0,8,17,378
52827,416,19,0,18,285,738
52828,664,0,0,0,7,671
52830,22,0,0,1,1,24
52839,703,13,0,2,50,768
52840,522,13,141,3,37,716
52842,793,10,0,2,48,853
52843,640,6,0,4,102,752
52845,291,3,0,7,25,326
52846,84,2,0,0,3,89
52847,240,1,0,0,5,246
52851,1009,9,141,17,95,1271
52852,612,12,0,20,329,973
52856,158,61,0,0,17,236
52858,1157,11,0,22,242,1432
52859,1348,78,0,45,653,2124
52861,1468,39,0,41,557,2105
52862,3943,42,427,64,1072,5548
52864,1009,11,0,7,153,1180
52866,2133,69,0,28,617,2847
52869,446,3,0,2,40,491
52870,76,0,0,0,0,76
52871,3382,113,428,123,1132,5178
52872,1549,122,141,16,337,2165
52873,1251,96,0,17,195,1559
52874,339,4,0,9,17,369
52876,708,28,0,21,240,997
52877,257,2,0,1,4,264
52879,367,20,0,2,47,436
52881,983,34,0,13,527,1557
52887,328,9,139,6,85,567
52890,341,1,143,1,1,487
52892,2173,51,0,21,232,2477
52894,127,2,2,0,2,133
52896,542,36,0,7,111,696
52897,442,6,0,0,76,524
52898,1000,67,0,72,279,1418
52899,277,1,0,0,114,392
52903,398,156,139,62,280,1035
52904,1622,40,141,30,728,2561
52906,788,14,0,8,39,849
52907,301,6,0,14,51,372
52908,394,2,0,14,43,453
52909,388,116,0,18,73,595
52911,713,28,0,20,366,1127
52912,441,3,17,0,14,475
52916,656,26,0,22,223,927
52917,651,14,0,21,127,813
52918,415,0,139,1,4,559
52920,362,1,0,0,20,383
52923,1213,15,4,8,323,1563
52925,1726,10,141,26,252,2155
52926,432,8,0,0,37,477
52927,156,0,0,0,1,157
52928,3620,24,144,25,745,4558
52930,1600,1,2,0,82,1685
52932,827,31,0,22,242,1122
52934,275,1,0,0,151,427
52935,1861,17,141,19,384,2422
52937,1973,90,345,33,127,2568
52938,669,2,0,4,53,728
52939,529,12,143,0,126,810
52940,1221,50,288,29,505,2093
52941,495,23,0,17,287,822
52944,1125,2,6,6,96,1235
52945,614,73,81,1,80,849
52946,238,22,270,4,167,701
52947,1346,14,285,19,269,1933
52948,615,139,144,20,311,1229
52951,1220,13,218,26,164,1641
52952,496,1,0,0,87,584
52953,1260,4,0,16,262,1542
52955,1194,3,0,0,154,1351
52958,244,0,0,0,0,244
52960,247,20,0,6,76,349
52962,932,56,0,44,388,1420
52964,835,25,0,3,287,1150
52966,270,0,0,0,5,275
52967,453,29,0,32,28,542
52968,2555,16,143,1,213,2928
52971,1485,87,288,34,492,2386
52972,2190,103,0,43,436,2772
52973,645,54,0,12,77,788
52974,2342,55,426,55,560,3438
52977,1360,20,0,43,281,1704
52979,813,0,0,3,46,862
52980,3378,16,294,25,824,4537
52982,977,44,0,32,559,1612
52984,769,0,0,5,131,905
52986,383,3,0,4,73,463
52988,1614,7,0,1,194,1816
52989,1339,3,2,9,104,1457
52991,1470,8,0,12,93,1583
52993,1130,131,6,17,310,1594
53001,424,1,0,4,13,442
53003,922,13,0,24,469,1428
53004,346,3,0,0,56,405
53005,224,38,0,0,32,294
53006,18035,284,428,181,6955,25883
53008,800,5,0,10,168,983
53009,699,3,0,9,66,777
53013,458,8,0,2,38,506
53018,1347,16,0,20,408,1791
53019,153,6,0,2,37,198
53022,1622,3,0,3,267,1895
53024,751,62,285,61,441,1600
53025,956,35,0,12,175,1178
53029,715,14,432,12,108,1281
53036,104,0,0,0,0,104
53037,1570,30,143,0,193,1936
53040,327,40,0,9,41,417
53043,1491,9,109,6,260,1875
53047,11,0,0,0,0,11
53049,552,7,0,1,123,683
53050,1614,2,143,9,131,1899
53051,133,2,0,0,3,138
53052,710,83,0,70,316,1179
53053,2251,9,230,2,271,2763
53054,1700,24,0,24,335,2083
53058,568,4,0,0,44,616
53059,5081,256,573,127,1562,7599
53061,1855,50,0,73,1055,3033
53062,5135,159,285,90,1965,7634
53065,4167,18,101,29,554,4869
53066,4243,48,0,64,537,4892
53067,733,0,0,0,30,763
53070,777,2,0,0,3,782
53071,177,1,0,0,2,180
53072,1075,22,0,16,127,1240
53073,12,1,0,1,0,14
53075,4714,347,428,134,1133,6756
53076,195,20,0,2,5,222
53080,4030,27,481,30,483,5051
53081,924,2,0,5,191,1122
53082,597,79,0,14,85,775
53085,2221,198,143,20,915,3497
53086,1012,25,0,29,246,1312
53088,1323,33,143,49,574,2122
53089,1020,29,0,30,382,1461
53090,1718,38,0,20,570,2346
53094,1066,1,143,3,146,1359
53095,567,6,0,2,88,663
53096,101,11,144,15,2,273
53097,750,1,143,1,100,995
53100,420,1,0,0,4,425
53102,1960,18,286,25,625,2914
53104,771,11,0,8,177,967
53106,797,4,0,4,100,905
53109,800,7,0,15,262,1084
53110,673,6,0,6,109,794
53111,1410,0,0,0,30,1440
53112,1512,4,116,4,75,1711
53113,727,0,0,9,106,842
53114,766,6,0,2,127,901
53115,839,31,0,11,282,1163
53116,415,2,0,0,38,455
53119,394,6,212,1,9,622
53120,420,106,0,32,289,847
53122,3470,63,0,55,1094,4682
53123,1163,12,0,22,376,1573
53125,1026,7,0,6,127,1166
53127,1056,0,0,7,136,1199
53130,1408,4,13,17,29,1471
53131,3353,39,143,80,993,4608
53132,1025,80,430,3,127,1665
53133,912,5,0,7,293,1217
53134,891,1,143,4,53,1092
53135,3095,398,282,80,637,4492
53137,2998,88,563,82,1136,4867
53138,1699,39,0,11,166,1915
53139,521,43,143,5,59,771
53140,942,6,158,1,65,1172
53142,1787,664,278,133,944,3806
53143,3857,42,144,57,1218,5318
53145,1540,7,91,24,361,2023
53146,1045,16,0,10,184,1255
53149,986,17,0,16,172,1191
53152,1687,24,0,53,401,2165
53153,28,6,8,5,0,47
53155,842,7,141,5,63,1058
53156,763,4,0,3,103,873
53158,3011,53,425,56,1040,4585
53162,857,213,0,20,205,1295
53164,1779,253,0,3,53,2088
53165,1119,3,0,13,153,1288
53166,834,12,143,0,18,1007
53167,1626,13,13,15,429,2096
53169,2552,8,143,9,225,2937
53170,1009,62,0,25,270,1366
53171,1787,20,141,11,354,2313
53172,1334,17,143,28,279,1801
53174,721,4,0,4,77,806
53175,2091,3,98,33,264,2489
53178,1817,3,0,2,172,1994
53180,1052,4,143,3,119,1321
53181,966,406,0,18,198,1588
53182,743,9,0,2,82,836
53183,311,5,0,1,8,325
53184,6107,49,282,85,715,7238
53185,570,0,0,0,5,575
53187,769,13,53,0,16,851
53189,1411,24,0,21,325,1781
53190,850,2,143,11,129,1135
53191,925,1,0,4,66,996
53194,700,44,0,23,89,856
53195,1543,9,143,30,111,1836
53196,679,32,0,1,16,728
53198,229,0,0,0,4,233
53199,1124,20,287,5,116,1552
53201,999,79,0,10,317,1405
53203,795,27,0,6,0,828
53205,1021,49,0,14,64,1148
53206,1069,7,0,1,133,1210
53209,1628,124,0,76,839,2667
53211,390,83,0,20,207,700
53213,855,11,0,3,209,1078
53214,629,1,0,6,17,653
53216,192,1,0,0,4,197
53217,1222,13,0,7,256,1498
53218,1521,1,421,1,34,1978
53219,171,16,141,4,33,365
53222,1708,25,141,39,333,2246
53223,1185,2,0,0,85,1272
53224,895,0,0,0,20,915
53227,730,24,0,13,140,907
53230,1069,9,0,13,160,1251
53231,1149,53,0,34,659,1895
53232,637,5,246,0,45,933
53233,6,95,0,0,1,102
53234,831,37,0,33,294,1195
53237,3429,76,284,50,326,4165
53238,714,22,0,8,116,860
53239,884,45,0,6,93,1028
53240,2699,13,430,12,569,3723
53241,694,9,0,4,80,787
53242,2188,26,0,15,157,2386
53245,734,9,144,25,398,1310
53246,537,132,144,1,4,818
53256,80,0,31,0,0,111
53259,0,0,0,0,0,0
53271,0,0,0,0,0,0
53274,0,0,66,17,101,184
53280,0,0,0,0,0,0
53282,0,0,0,0,0,0
53292,0,0,0,0,0,0
53301,0,0,0,0,0,0
53338,29,0,0,0,0,29
53347,0,0,0,0,0,0
53355,0,0,0,0,0,0
53407,0,0,0,0,0,0
53423,0,0,0,0,0,0
53435,0,0,0,0,0,0
53449,0,0,0,0,0,0
53460,0,0,0,0,0,0
53488,326,0,688,16,16,1046
53507,0,0,0,0,0,0
53508,0,0,0,0,0,0
53513,452,2,42,0,21,517
53536,492,65,126,3,220,906
53543,1155,10,0,1,281,1447
53548,375,45,139,7,294,860
53586,0,0,0,0,0,0
53587,19,0,0,0,0,19
53610,0,0,0,0,0,0
53641,263,3,0,4,16,286
53646,0,0,0,0,0,0
53667,2,3,9,92,0,106
53695,0,0,0,0,0,0
53703,0,0,0,0,0,0
53726,0,0,0,0,0,0
53732,0,0,0,0,0,0
53755,0,0,0,16,283,299
53766,337,2,20,11,19,389
5378,845,0,86,11,360,1302
53813,1156,581,128,51,488,2404
53823,436,9,58,2,149,654
53828,202,0,0,0,4,206
53832,0,0,0,0,0,0
53836,0,0,119,7,0,126
53848,1,0,0,0,0,1
5385,0,0,78,0,321,399
53859,550,53,8,14,329,954
53896,1004,43,359,8,620,2034
5390,0,0,0,0,0,0
53907,87,0,4,2,2,95
53913,0,1,17,0,0,18
5394,6946,173,659,22,925,8725
53949,0,0,0,0,0,0
53959,1,0,0,4,0,5
5396,7941,349,616,21,288,9215
53971,699,1,13,0,15,728
53989,116,0,13,0,0,129
5400,2237,18,858,1,0,3114
54004,1,0,132,8,0,141
54006,0,0,0,0,0,0
54039,0,0,0,0,0,0
54057,0,0,0,0,0,0
54075,0,0,0,0,0,0
5408,399,12,65,6,3,485
54084,0,0,0,0,0,0
5410,4222,0,1031,3,373,5629
54115,272,0,0,0,1,273
54119,622,1,0,2,50,675
5413,240,0,111,7,13,371
54133,0,0,0,0,0,0
54139,1266,14,84,0,406,1770
54142,0,0,92,0,0,92
54154,1430,17,20,7,183,1657
54155,0,0,0,0,0,0
54182,1623,53,170,9,487,2342
54198,4252,69,220,46,797,5384
54221,435,5,78,11,83,612
54225,0,0,0,0,0,0
54239,0,0,0,0,0,0
54240,0,0,0,0,0,0
5429,0,3,91,0,1,95
54290,0,0,0,0,0,0
54301,0,0,0,7,0,7
54314,60,1,0,4,2,67
5432,215,0,1429,3,21,1668
54326,0,0,0,0,0,0
54327,809,24,141,2,185,1161
54328,0,0,0,0,0,0
54329,1404,0,0,0,0,1404
54337,15,0,0,0,0,15
54359,633,3,0,1,58,695
54373,0,0,0,0,0,0
54448,100,10,118,22,78,328
54458,288,19,105,10,116,538
54483,279,5,17,0,0,301
54501,0,0,0,0,0,0
54507,0,0,0,0,0,0
54512,0,0,0,0,0,0
54519,0,0,0,0,0,0
54540,0,0,0,0,0,0
54574,970,1,0,16,112,1099
54578,0,0,0,0,0,0
54579,0,0,0,0,0,0
54600,1201,149,11,44,746,2151
54607,0,0,0,0,0,0
54614,6576,23,400,12,1690,8701
54640,0,0,0,0,0,0
54646,681,3,2,0,75,761
54648,274,0,0,1,3,278
54650,0,0,0,0,0,0
5466,20478,5976,1676,28,9131,37289
54665,0,0,0,0,0,0
5467,514,1,0,0,114,629
5470,144,0,15,0,1,160
54755,896,50,63,6,286,1301
5479,469,9,24,1,12,515
54804,0,0,0,0,0,0
54809,0,0,0,0,0,0
54816,0,0,0,0,0,0
54825,2,0,0,5,0,7
5483,1939,1,1191,0,11,3142
54841,973,10,104,10,209,1306
54858,5924,487,551,154,1756,8872
54885,526,4,0,0,6,536
54904,95,0,0,1,5,101
54911,0,0,25,1,0,26
54923,0,0,0,0,0,0
54932,0,0,0,0,0,0
54933,0,0,0,0,0,0
54934,166,0,0,1,19,186
54936,0,0,8,4,34,46
54938,0,0,0,0,0,0
5495,230,0,54,0,0,284
54973,0,0,0,0,0,0
54979,0,0,0,0,0,0
54980,751,1,69,3,91,915
54989,0,0,22,0,0,22
54994,305,1,0,0,0,306
55,0,0,0,0,0,0
55003,466,21,68,1,132,688
55009,0,0,0,0,0,0
5503,0,0,0,0,0,0
55039,948,47,17,4,108,1124
55076,0,0,0,0,0,0
55081,66,0,12,91,0,169
55120,0,0,0,0,0,0
5513,0,0,29,0,0,29
55140,1,0,0,0,0,1
55142,0,0,0,0,0,0
55145,1,0,166,1,0,168
55178,0,0,0,0,0,0
5518,2373,18,438,3,529,3361
55183,0,0,0,0,0,0
55193,782,13,10,5,377,1187
55194,0,0,0,0,0,0
55214,1346,173,181,34,777,2511
5523,1,37,11,0,0,49
55230,33,0,0,0,0,33
55236,59,0,9,0,8,76
5524,0,0,80,0,0,80
55246,1208,10,33,0,254,1505
55254,0,2,15,0,0,17
55256,81,1,0,0,2,84
55286,142,14,45,32,99,332
553,9188,32,478,5,678,10381
55308,1,0,0,0,0,1
55309,935,2,17,7,18,979
5532,1297,123,15,3,7,1445
55322,1726,14,238,14,24,2016
55333,288,142,0,4,6,440
55341,1510,763,842,60,469,3644
55352,8585,3976,4698,415,3095,20769
55353,744,185,211,10,71,1221
55355,1111,9,47,5,12,1184
55380,502,2,0,0,11,515
55381,0,0,0,0,16,16
55382,409,3,0,0,11,423
55387,2,1,0,4,0,7
55391,0,0,0,0,0,0
55392,1526,415,288,33,1318,3580
55403,0,20,4,4,0,28
55410,1208,1094,482,50,52,2886
55415,285,77,141,16,73,592
55423,2395,1173,169,25,573,4335
55427,0,0,0,0,0,0
55430,8610,6055,1211,927,8288,25091
55441,946,152,59,20,104,1281
55461,8,4,4,0,0,16
5547,0,0,0,0,0,0
55476,0,0,4,0,1,5
55482,310,292,19,1,16,638
5550,0,0,0,0,0,0
55507,220,67,49,5,12,353
5553,0,1,11,0,0,12
55536,8,9,0,0,0,17
5555,72,0,0,7,1,80
55577,5,1678,80,239,0,2002
55586,166,0,0,0,0,166
55615,5,0,0,0,0,5
55618,6,0,0,0,0,6
5563,0,0,4,0,0,4
55636,24,116,129,12,0,281
55644,4986,487,92,321,2202,8088
55649,1588,3,0,24,40,1655
55652,767,31,118,9,63,988
55653,666,103,126,11,82,988
55664,286,199,35,1,253,774
55665,1273,135,73,9,440,1930
55666,3702,763,357,20,817,5659
55670,660,74,82,1,279,1096
55672,8,6,0,0,0,14
55685,1942,425,6,24,597,2994
55687,258,175,0,0,137,570
55699,4071,1015,0,88,1613,6787
557,0,0,414,0,0,414
55701,1351,82,254,4,249,1940
55720,120,199,42,9,1,371
5576,312,2,16,1,2,333
55769,1600,383,257,5,410,2655
5577,651,16,22,0,2,691
5578,0,0,733,2,13,748
55799,72,2,0,3,30,107
5580,6,1,0,0,0,7
55821,7857,237,1206,22,688,10010
55824,54,1183,168,41,0,1446
55832,2524,425,127,50,125,3251
55836,10379,82813,1110,10546,9553,114401
55839,308,163,258,26,183,938
55862,3117,918,1349,95,736,6215
55879,1694,588,461,68,356,3167
5588,977,0,885,10,191,2063
559,25,0,18,0,233,276
55900,525,0,0,0,209,734
55933,501,13,0,6,40,560
55947,1838,1449,958,129,797,5171
55958,2,0,0,0,0,2
55967,17,0,0,1,0,18
55990,3394,0,80,67,9,3550
55992,817,0,0,1,8,826
5602,9871,1018,815,27,1112,12843
5603,31436,370,2766,70,2581,37223
56040,4835,1596,551,63,3390,10435
56041,5181,427,190,9,499,6306
56042,1830,113,45,1,31,2020
56044,2,46,10,0,6,64
56046,6074,351,171,10,713,7319
56047,31,0,17,0,35,83
56048,1448,382,252,0,36,2118
56050,0,2,51,0,0,53
5606,4416,94,769,23,375,5677
56067,702,224,0,2,234,1162
5607,1015,0,385,1,579,1980
56099,5303,138,1082,60,1113,7696
5610,953,0,1296,1,675,2925
56120,288,150,6,14,328,786
56132,1164,47,0,0,217,1428
56141,859,3,2,1,19,884
56146,566,0,44,1,97,708
56149,8,0,0,0,0,8
56155,170,0,0,0,0,170
5617,18,0,2917,6,424,3365
56209,2955,1340,950,218,1040,6503
56224,288,291,141,38,219,977
56233,686,10,2,1,81,780
56234,328,118,15,0,128,589
56239,911,426,62,16,461,1876
56241,339,6,62,0,6,413
56242,1480,242,274,7,686,2689
56245,261,1,0,0,1,263
56246,976,198,141,4,333,1652
56255,252,50,112,9,30,453
5626,0,0,2,1,15,18
56260,205,14,100,1,13,333
56262,1600,94,587,50,678,3009
56268,0,580,238,28,0,846
56272,0,161,160,10,0,331
56300,8052,2292,572,358,3137,14411
56309,1,4,0,0,0,5
56329,0,0,0,0,0,0
56344,0,0,40,0,0,40
56349,0,0,0,0,0,0
56376,1180,4,184,8,93,1469
56391,0,0,98,0,0,98
56420,0,14,99,0,0,113
56426,0,2,33,0,0,35
56427,0,0,0,0,11,11
5645,9189,358,567,75,2583,12772
56450,0,0,9,0,16,25
56456,0,0,183,0,0,183
56468,590,3,9,0,36,638
56472,565,0,24,0,130,719
56476,0,1,13,0,0,14
56478,0,0,80,1,1,82
56497,69,0,236,3,27,335
56498,90,1,144,0,10,245
5650,56927,2302,5353,364,13297,78243
5653,634,12,0,1,2,649
56534,0,163,0,0,0,163
56535,0,0,0,0,0,0
56541,0,1,0,1,0,2
56546,19,0,0,0,8,27
56550,1552,43,91,8,303,1997
56566,0,0,23,0,0,23
56595,0,0,0,0,0,0
56606,0,0,0,0,6,6
5661,0,0,0,0,0,0
56624,0,0,13,0,0,13
56630,28,5,9,0,0,42
56642,0,0,0,0,2,2
56655,0,1,13,0,0,14
56656,0,0,0,0,0,0
56664,0,31,94,0,0,125
56665,2310,4,267,3,94,2678
56681,11,1,0,0,0,12
56689,258,28,38,0,0,324
56690,0,1,0,0,0,1
56694,0,7,0,3,0,10
56724,0,9,63,0,0,72
56800,0,0,8,0,0,8
56816,0,0,0,0,1,1
56821,0,0,0,0,22,22
56828,532,0,0,0,0,532
56833,0,0,319,0,207,526
56843,0,0,0,0,22,22
56844,1,0,0,0,1,2
56874,0,41,11,0,4,56
56882,0,0,0,0,19,19
5690,0,6,0,0,0,6
56911,2707,99,463,8,817,4094
56912,267,0,2,0,5,274
56926,0,0,13,0,1,14
56933,0,0,0,0,0,0
57044,13,1,21,0,0,35
57069,0,0,62,0,1,63
5707,0,0,0,0,0,0
57074,0,0,29,0,5,34
57084,1342,34,158,1,414,1949
57111,447,7,2,0,84,540
57112,0,0,80,0,0,80
57131,1279,7,33,1,49,1369
57141,114,0,6,0,1,121
57154,0,0,68,0,0,68
57169,0,0,8,0,0,8
57172,0,0,73,0,0,73
57184,89,0,0,0,2,91
5719,0,0,0,0,0,0
57214,0,1,4,0,0,5
57223,1313,22,306,21,483,2145
5723,283,0,0,0,2,285
57248,0,0,4,5,0,9
57269,717,37,0,0,93,847
57279,0,0,64,1,36,101
57286,0,0,0,0,8,8
57287,0,0,0,0,0,0
57288,0,0,0,1,0,1
57294,16,0,0,0,0,16
57300,564,15,158,1,86,824
57333,0,8,26,0,0,34
57334,0,12,38,0,0,50
57344,78,0,292,0,345,715
57353,1710,1,390,5,51,2157
57370,0,0,36,0,670,706
5738,476,0,424,2,0,902
57389,0,0,0,0,0,0
57393,0,113,71,6,0,190
57399,0,0,9,0,22,31
5742,1118,38,60,31,544,1791
57421,0,23,11,1,0,35
57446,721,9,45,2,126,903
57469,1211,21,52,0,313,1597
57472,0,0,0,0,0,0
57476,0,0,0,0,0,0
57547,0,0,71,1,0,72
57558,684,5,26,19,232,966
57564,0,0,2,0,0,2
57566,0,0,6,0,0,6
57571,183,2,32,0,0,217
5758,0,0,0,0,0,0
5760,0,5,430,1,0,436
57606,0,0,0,0,0,0
57630,749,6,156,9,41,961
57634,16,0,63,0,16,95
57679,0,5,0,0,0,5
5769,13752,2833,2272,5,8790,27652
577,84712,776,4156,126,19003,108773
57705,0,0,24,5,46,75
57716,0,0,2,0,0,2
57722,734,15,0,4,315,1068
57728,73,0,82,2,8,165
57746,100,1,6,0,3,110
57760,0,0,2,0,0,2
5778,4814,17,89,9,307,5236
57791,1778,461,171,30,1017,3457
57794,0,0,13,6,83,102
57795,0,0,103,0,0,103
57809,28,0,77,0,1,106
57815,18,0,0,0,2,20
5783,279,0,0,0,0,279
57846,367,5,207,0,15,594
57873,341,40,11,0,90,482
57888,0,0,72,0,0,72
57889,0,0,0,0,0,0
57893,0,8,78,0,0,86
57904,0,0,11,0,1,12
57910,0,0,0,0,0,0
57963,847,11,31,0,261,1150
57970,0,0,2,0,2,4
58002,0,0,9,0,0,9
58022,1107,17,206,11,113,1454
58044,0,0,101,0,0,101
58046,82,0,0,0,0,82
58061,0,0,0,0,0,0
58065,563,39,4,8,118,732
58073,0,0,0,0,0,0
58075,0,0,9,0,0,9
58079,0,0,13,0,50,63
58088,102,1,4,0,7,114
58098,0,0,0,0,0,0
58128,42,0,0,1,5,48
58130,0,0,6,1,0,7
58134,0,0,6,0,0,6
58150,294,0,15,1,69,379
58219,0,1,2,1,0,4
58220,0,0,0,0,0,0
58243,1200,23,43,0,118,1384
58253,160,5,20,0,14,199
58264,735,11,110,7,87,950
58269,92,1,2,0,5,100
58285,0,152,79,0,0,231
58328,0,0,46,6,0,52
58350,0,0,8,0,0,8
58369,953,140,0,4,234,1331
58375,12,4,0,0,1,17
58376,181,22,0,0,4,207
58387,1,1,8,0,0,10
58392,158,9,74,0,3,244
58396,191,32,0,0,39,262
58405,237,15,142,0,47,441
58411,758,2,8,21,3,792
58424,2432,10,561,7,139,3149
58453,0,0,51,0,0,51
58461,3591,260,4,3,25,3883
58466,2425,47,82,13,127,2694
58474,480,107,97,1,139,824
58477,1009,172,298,16,206,1701
58482,1601,311,353,12,397,2674
58485,288,223,144,24,241,920
58495,3049,1073,823,45,1776,6766
58504,0,41,2,0,0,43
58507,833,209,0,28,373,1443
58519,967,1,0,0,1,969
58521,355,220,9,13,4,601
58543,900,28,4,0,0,932
58553,287,74,8,8,111,488
58558,455,33,208,1,56,753
58563,1464,125,0,0,0,1589
58593,468,9,0,0,0,477
58594,465,131,413,23,35,1067
58640,32,20,91,5,1,149
58647,407,0,0,0,6,413
58648,0,0,0,0,0,0
58650,1,0,0,0,257,258
58659,4769,2214,2195,251,1517,10946
58678,9977,5377,5255,543,4473,25625
58757,601,2,4,1,36,644
58763,249,70,127,6,34,486
58812,0,0,0,0,0,0
58819,142,0,0,0,1,143
58820,259,63,2,2,143,469
58821,771,111,236,11,222,1351
58879,22,0,0,0,0,22
58898,2,865,348,72,0,1287
589,0,0,0,0,0,0
58906,4,6,9,0,0,19
58914,286,212,87,37,225,847
58930,279,123,4,2,1,409
58955,35,21,0,0,31,87
58963,286,202,144,21,124,777
58966,2107,909,994,97,862,4969
58967,140,30,53,8,129,360
58969,0,1045,353,137,0,1535
58971,5,147,55,22,0,229
59,0,0,0,0,0,0
59043,380,0,0,13,0,393
59045,279,1,0,17,13,310
59050,5,2,0,0,0,7
59108,8,131,0,6,59,204
59127,2,0,0,0,112,114
59139,534,73,184,20,217,1028
59148,329,0,0,0,12,341
59149,2,1,0,0,0,3
59150,288,189,144,24,233,878
59151,157,10,0,0,50,217
59155,288,75,136,4,110,613
59159,55,0,0,0,0,55
59162,65,5,0,0,1,71
59164,1878,959,646,102,767,4352
59165,794,331,262,21,129,1537
59179,0,139,76,3,0,218
59185,379,211,338,17,93,1038
59253,2307,552,6,64,546,3475
59273,106,12,0,4,19,141
59276,241,6,144,1,21,413
59278,510,30,0,2,65,607
59279,288,52,108,2,124,574
59282,847,220,280,9,348,1704
59322,587,1,4,0,27,619
59349,17,5,0,0,0,22
59466,0,0,164,6,283,453
59477,0,0,0,0,1,1
59478,0,0,8,0,0,8
59479,0,0,6,0,0,6
59504,167,2,0,0,0,169
59584,0,4,2,0,0,6
59665,0,8,99,0,0,107
59675,53,0,6,0,1,60
59693,0,31,0,0,0,31
59702,2979,22,82,6,730,3819
59711,0,0,0,0,0,0
59713,0,11,0,0,0,11
59729,0,0,0,0,0,0
59763,0,0,53,0,53,106
59766,2349,74,248,7,214,2892
59770,2,0,0,0,1,3
59784,478,1,17,0,52,548
59790,156,1,11,0,0,168
59793,0,65,135,0,0,200
59847,1,0,8,3,62,74
59862,800,3,8,7,17,835
59890,0,0,0,1,57,58
59913,581,25,188,2,297,1093
59919,1796,3,157,3,57,2016
59921,399,1,6,2,197,605
59959,0,0,0,0,1,1
59970,0,0,75,0,0,75
600,0,0,0,0,0,0
60016,1,0,2,0,120,123
60017,103,5,4,0,39,151
60020,164,0,56,3,23,246
60032,236,0,13,0,0,249
60042,0,0,15,0,0,15
60068,1529,405,4,51,283,2272
60111,2308,40,191,14,415,2968
60144,0,0,0,0,0,0
60155,248,14,46,0,84,392
60168,0,0,13,0,195,208
60182,0,0,2,0,27,29
60187,0,0,0,0,0,0
60202,0,0,2,0,0,2
60213,569,10,26,0,123,728
60214,58,0,0,0,1,59
60257,0,0,2,0,0,2
60278,58,0,0,0,2,60
60294,1733,76,255,1,907,2972
60296,0,0,0,0,0,0
60304,0,0,94,0,83,177
60325,0,0,0,3,29,32
60352,233,6,4,1,28,272
60367,278,0,288,0,32,598
60388,0,12,4,0,0,16
60397,23,0,0,0,0,23
60404,0,0,0,0,0,0
60409,852,23,157,23,441,1496
60441,0,0,138,0,212,350
60447,0,0,80,0,102,182
60451,351,2,224,13,27,617
60453,1171,22,332,7,169,1701
60458,0,0,6,3,13,22
60471,0,0,0,23,125,148
60496,0,1,0,0,0,1
60501,1153,10,177,4,88,1432
60522,1441,2,113,1,27,1584
60529,0,0,0,0,1,1
60530,170,3,28,3,49,253
60551,0,0,4,0,0,4
60558,0,0,2,0,0,2
60559,208,4,0,0,58,270
6056,0,0,0,0,0,0
6057,7488,3566,2029,223,1945,15251
60582,350,14,4,7,69,444
6059,554,4,0,1,26,585
60592,0,0,0,0,1,1
606,267,0,0,0,16,283
60609,0,0,6,0,0,6
60656,0,0,2,1,172,175
60715,0,0,0,0,0,0
60725,297,196,76,1,36,606
60740,0,0,2,0,0,2
60747,0,10,15,0,0,25
60770,58,0,0,0,13,71
60781,0,0,363,0,0,363
60783,178,1,19,1,16,215
6079,18540,190,5362,230,8162,32484
60798,343,2,67,1,7,420
60804,0,0,2,24,27,53
60822,1433,94,157,10,195,1889
60829,0,0,2,0,0,2
60857,120,0,0,0,84,204
60876,0,0,207,0,0,207
60907,377,2,275,3,101,758
60909,249,2,22,0,53,326
60919,0,6,29,0,0,35
60989,768,28,56,5,132,989
61000,537,6,19,1,23,586
61003,356,27,2,19,245,649
61006,228,0,90,4,10,332
61046,0,0,0,1,0,1
6106,0,0,0,0,0,0
61071,0,0,14,0,80,94
611,444,5,0,0,4,453
61109,0,0,0,0,13,13
6111,0,0,0,0,0,0
6112,0,0,0,0,0,0
61124,0,0,0,0,0,0
61139,19,0,13,0,80,112
61145,312,3,0,2,39,356
61174,0,0,0,0,216,216
61204,8,0,0,0,1,9
6122,0,0,0,0,0,0
61244,554,1,195,0,5,755
61272,0,0,0,0,0,0
61275,4232,29,192,14,808,5275
6128,3543,80,13962,251,37,17873
61296,0,0,0,0,0,0
61315,0,0,113,0,0,113
61317,1454,41,49,103,304,1951
61344,0,1,31,0,0,32
61382,0,1,11,0,0,12
61429,0,0,116,0,0,116
61437,0,0,18,0,23,41
61449,246,18,250,0,5,519
61452,194,61,76,4,23,358
61456,162,87,144,17,42,452
61460,370,162,11,10,113,666
61466,1544,462,318,53,372,2749
61470,153,96,81,11,13,354
61481,268,98,0,10,11,387
61487,303,99,276,0,21,699
61490,405,59,0,12,142,618
61493,139,105,288,1,11,544
61500,99,53,0,10,17,179
61503,239,79,11,20,73,422
61508,96,43,257,1,4,401
61509,225,44,144,7,22,442
61512,796,25,287,16,246,1370
61514,96,13,2,0,6,117
61519,141,58,144,4,32,379
61523,113,63,144,4,21,345
61568,64,20,0,0,0,84
6157,3,0,0,0,0,3
61578,86,0,0,1,6,93
61581,15,3,141,0,0,159
61582,256,113,0,19,146,534
61583,597,91,0,9,140,837
61584,615,0,139,4,63,821
61585,19,0,0,4,0,23
61587,288,10,0,14,103,415
61588,1956,9,271,8,242,2486
61590,646,2,0,1,3,652
61591,589,164,139,55,267,1214
61595,625,5,0,14,145,789
61597,196,7,0,0,10,213
61632,1183,14,148,20,263,1628
61633,597,6,0,11,142,756
61636,784,6,144,5,98,1037
61637,435,6,0,8,132,581
61638,502,4,144,17,199,866
61639,461,1,282,1,48,793
61641,522,3,0,0,9,534
61642,400,7,0,12,49,468
61646,441,7,141,0,27,616
61648,940,2,271,1,52,1266
61649,1271,25,0,32,418,1746
61650,545,18,144,17,137,861
61653,432,7,9,1,21,470
61657,573,14,0,23,198,808
61659,364,10,152,24,113,663
61660,387,99,139,50,120,795
61662,474,8,0,1,157,640
61663,810,34,144,11,48,1047
61665,290,52,0,24,85,451
61666,1843,41,296,36,304,2520
61667,356,2,0,8,5,371
61668,328,13,141,16,71,569
6167,15248,628,766,33,2355,19030
61670,211,44,0,14,24,293
61671,480,21,285,14,115,915
61672,555,7,285,5,84,936
61673,569,1,143,0,4,717
61677,586,1,0,9,60,656
61678,38,0,144,0,0,182
61680,162,5,0,1,51,219
61681,553,10,0,13,200,776
61686,320,3,0,1,11,335
61689,742,18,0,27,185,972
61691,59,1,144,0,4,208
61694,1075,1,149,10,170,1405
61696,665,10,144,3,47,869
61697,249,30,0,14,68,361
61698,225,18,283,4,32,562
61699,403,5,282,13,81,784
61700,685,7,141,4,102,939
61704,210,6,0,7,112,335
61705,262,28,137,8,73,508
61706,278,25,0,2,85,390
61707,313,6,0,0,81,400
61708,627,10,0,11,213,861
61709,631,6,428,15,359,1439
61710,309,1,0,0,8,318
61711,476,19,0,17,209,721
61712,435,8,144,5,131,723
61713,408,0,144,2,11,565
61714,237,23,4,1,7,272
61716,406,6,0,11,11,434
61717,1164,21,0,5,153,1343
61718,378,1,0,0,16,395
61722,128,28,0,16,63,235
61723,434,26,0,14,93,567
61724,330,1,0,0,1,332
61725,353,8,0,1,38,400
61728,327,8,0,8,76,419
61729,451,5,144,7,104,711
61730,725,41,428,12,186,1392
61731,226,61,141,11,81,520
61732,726,7,0,11,57,801
61738,260,7,127,8,25,427
61741,934,25,143,11,165,1278
61743,451,4,141,0,61,657
61744,260,57,248,12,115,692
61748,1175,1,0,5,119,1300
61751,653,190,416,43,339,1641
61752,72,0,0,0,2,74
61753,813,3,184,13,177,1190
61754,873,2,0,5,58,938
61755,542,3,286,26,120,977
61756,594,15,0,9,138,756
61759,318,1,0,0,26,345
61761,414,77,190,47,154,882
61762,434,3,0,1,53,491
61763,405,1,0,1,2,409
61764,290,14,24,0,11,339
61765,538,3,183,1,26,751
61766,469,6,0,4,5,484
61768,723,21,284,22,397,1447
61772,1324,22,569,26,426,2367
61773,714,8,358,9,114,1203
61775,568,0,0,8,109,685
61782,510,1,96,13,79,699
61784,791,10,144,15,190,1150
61785,585,11,212,9,32,849
61787,285,0,0,2,4,291
61792,838,55,227,51,400,1571
61793,233,7,102,1,58,401
61794,660,10,144,4,120,938
61795,118,4,284,1,2,409
61796,517,1,8,0,8,534
61797,1115,75,141,20,163,1514
61798,117,3,0,4,4,128
61799,321,0,0,0,13,334
61800,424,5,0,3,14,446
61802,458,6,157,3,34,658
61805,1099,7,0,21,245,1372
61806,145,14,35,1,163,358
6181,17383,194,1560,110,3443,22690
61810,413,1,139,5,35,593
61811,755,91,353,24,197,1420
61816,395,2,12,4,32,445
61818,383,9,131,2,131,656
61819,455,9,145,23,92,724
61821,352,2,13,0,21,388
61822,648,10,203,19,128,1008
61823,318,15,0,3,110,446
61824,472,50,235,3,38,798
61826,281,39,44,2,19,385
61827,195,11,0,4,3,213
61828,341,12,119,8,85,565
61830,315,0,284,0,10,609
61834,791,1,254,9,118,1173
61836,179,48,0,20,52,299
61839,453,1,141,0,19,614
61844,301,5,144,0,59,509
61847,476,1,144,7,5,633
61849,61,1,286,0,0,348
61851,137,0,244,0,6,387
61853,446,1,0,0,24,471
61855,445,3,0,8,81,537
61856,525,10,287,22,123,967
61857,100,0,0,0,2,102
61858,483,4,136,3,38,664
61862,110,0,44,0,8,162
61863,539,7,0,8,76,630
61864,451,1,255,9,3,719
61865,99,0,0,0,3,102
61868,228,1,0,1,14,244
61869,423,49,144,5,121,742
61870,850,6,0,2,24,882
61872,544,8,378,2,134,1066
61874,543,1,0,3,79,626
61878,1079,14,428,39,237,1797
61885,578,4,143,6,120,851
61886,190,12,4,0,46,252
61889,1418,20,538,2,118,2096
61890,386,19,77,5,90,577
61893,2144,78,0,44,799,3065
61895,1601,17,143,13,128,1902
61897,120,11,0,6,31,168
61900,989,2,0,10,107,1108
61901,886,30,141,22,556,1635
61902,1070,12,285,1,102,1470
61904,537,6,0,0,14,557
61906,687,5,0,12,103,807
61908,750,112,0,76,145,1083
61910,842,1,0,5,18,866
61912,346,3,147,0,19,515
61914,889,27,0,23,534,1473
61915,370,0,0,1,29,400
61917,973,10,0,1,47,1031
61918,768,14,144,27,279,1232
61919,458,2,241,5,124,830
6192,1307,3,0,0,78,1388
61920,1264,2,395,9,84,1754
61922,488,2,278,8,83,859
61923,998,53,428,51,577,2107
61924,1,0,0,0,0,1
61928,0,0,12,0,0,12
61929,550,14,335,8,176,1083
61930,176,0,287,0,12,475
61931,694,1,0,18,45,758
61932,160,1,10,1,2,174
61934,1275,11,370,8,190,1854
61935,114,0,139,0,16,269
61936,808,12,48,12,103,983
61937,1038,1,368,4,295,1706
61938,431,2,323,1,13,770
61939,874,47,287,7,85,1300
61940,1206,12,280,7,90,1595
61941,882,30,421,49,413,1795
61942,1542,12,254,26,251,2085
61945,805,3,349,0,83,1240
61948,254,3,2,3,20,282
61949,491,128,0,26,191,836
61951,65,6,0,3,11,85
61979,0,0,0,0,0,0
62,328,1,0,1,1,331
6200,0,0,0,0,0,0
62000,8,0,0,1,0,9
62007,753,12,130,2,101,998
62009,203,4,67,0,29,303
62015,0,0,123,0,1,124
62023,269,0,153,0,1,423
62038,700,0,4,0,61,765
62044,152,1,2,0,3,158
62059,1046,149,83,9,415,1702
62064,0,0,0,1,0,1
62099,0,0,15,1,0,16
62105,0,0,0,0,0,0
62106,0,0,8,0,33,41
62129,778,34,13,0,175,1000
62142,0,0,11,0,0,11
62166,992,4,13,0,41,1050
62178,0,0,111,0,0,111
62183,1134,249,286,0,236,1905
62208,8,0,0,0,0,8
62225,1204,6,45,14,97,1366
62235,0,0,6,0,66,72
62240,24,0,15,8,9,56
62275,471,1,35,1,29,537
62319,316,215,71,0,16,618
62323,0,0,4,0,19,23
6233,239,1,0,1,88,329
62336,2734,5,631,0,188,3558
62343,62,0,22,0,75,159
62351,30,0,4,0,1,35
62352,8,0,0,0,9,17
62365,1348,4,121,0,50,1523
62386,0,0,0,0,59,59
62455,431,61,6,1,167,666
62476,36,0,19,0,58,113
62482,0,0,0,0,0,0
6250,226,2,12,6,42,288
62511,380,3,8,0,118,509
62514,859,20,301,1,279,1460
62523,0,0,286,1,0,287
62544,0,0,0,0,0,0
62563,106,22,0,26,130,284
62585,2,0,0,0,0,2
62618,0,0,0,0,0,0
62622,0,0,0,0,0,0
6263,0,0,0,0,0,0
62637,0,0,0,1,0,1
62640,0,0,0,0,0,0
62642,568,13,2,12,39,634
62643,0,0,0,0,0,0
62646,0,0,0,0,0,0
62648,0,0,0,0,0,0
62658,0,0,0,0,0,0
62674,0,0,0,0,0,0
62684,0,0,0,0,0,0
62724,0,0,0,0,0,0
62727,0,0,0,0,0,0
62738,0,0,0,0,0,0
62759,0,0,0,0,0,0
62798,0,0,0,0,0,0
6280,2350,3,156,0,112,2621
62802,0,0,0,0,0,0
62809,726,24,139,18,144,1051
62814,978,2,6,2,375,1363
62825,0,0,0,0,0,0
62845,397,2,97,0,37,533
62874,5,0,0,1,1,7
62880,1461,26,370,34,581,2472
62886,0,0,0,0,0,0
62887,50,0,0,0,2,52
62904,0,0,0,16,0,16
62915,580,79,155,14,494,1322
62943,0,0,0,0,0,0
62969,1092,6,0,1,211,1310
63,0,0,0,0,0,0
6300,0,0,0,0,0,0
63010,0,0,0,0,0,0
63018,33,5,97,22,2,159
63023,314,80,28,51,254,727
63033,0,0,0,0,0,0
63052,612,33,83,5,71,804
63060,126,1,2,0,10,139
63069,336,15,36,3,94,484
63089,0,0,0,0,0,0
63100,0,0,0,0,0,0
63107,1,0,0,0,0,1
63133,0,0,0,0,0,0
63134,1470,28,40,0,436,1974
6315,689,0,0,0,0,689
63178,0,0,0,0,0,0
63182,0,0,0,0,0,0
63186,1,0,0,0,0,1
63199,636,4,0,4,41,685
63242,0,0,0,0,0,0
6325,0,0,134,0,0,134
63267,0,0,0,0,0,0
6327,160298,8876,3440,742,39513,212869
63275,0,0,0,0,0,0
63296,0,0,0,0,0,0
63298,1558,66,202,2,426,2254
6332,1,1,585,3,364,954
63330,0,0,0,0,0,0
63353,0,0,0,0,0,0
63383,40,0,15,3,2,60
63394,0,0,0,0,0,0
63400,0,0,0,0,0,0
63414,0,0,0,0,0,0
63436,0,0,0,0,0,0
63448,0,0,15,0,0,15
63457,0,0,0,0,0,0
63466,0,0,0,0,0,0
63473,217,2,15,17,42,293
63474,0,0,0,0,0,0
63483,0,0,0,0,0,0
63490,250,19,0,0,66,335
63497,46,6,0,0,1,53
63501,493,13,131,4,89,730
63508,286,95,141,21,132,675
63510,6,1,0,0,0,7
6356,0,0,0,0,0,0
6360,0,0,0,0,0,0
63620,210,1,0,4,9,224
6364,0,0,0,0,0,0
6368,1,0,0,0,0,1
63691,2,1,0,0,0,3
63731,238,49,106,0,3,396
63741,1635,2,317,15,134,2103
63747,162,0,61,2,3,228
63775,513,0,0,0,37,550
63835,473,5,0,0,0,478
63859,5878,1943,324,110,2390,10645
63867,283,9,0,1,27,320
63868,395,46,143,12,100,696
63873,268,5,2,1,48,324
63882,285,138,0,1,216,640
63885,284,55,139,10,130,618
63888,2999,4,70,50,578,3701
6389,1639,7,0,0,5,1651
6391,405,17,18,3,211,654
63916,821,3,0,26,121,971
63920,16,0,0,0,0,16
63927,1252,8,48,3,72,1383
63930,1120,318,300,22,794,2554
63949,21979,3057,1038,906,8749,35729
63981,712,2,0,6,8,728
64008,58,1,50,1,10,120
64022,911,0,0,22,90,1023
64024,286,92,141,14,110,643
64026,41,9,0,0,5,55
64027,576,228,144,10,281,1239
64029,331,62,138,2,88,621
64050,2186,11,26,26,164,2413
6407,2124,4,0,2,328,2458
64096,371,9,44,7,4,435
64099,162,63,95,13,28,361
64111,101,84,134,3,6,328
64117,131,33,10,4,2,180
64200,0,0,0,0,0,0
64225,0,0,0,0,0,0
64227,0,0,0,0,0,0
64236,0,0,0,0,0,0
64242,443,8,29,7,89,576
64249,0,0,0,0,0,0
64267,0,1,0,0,1,2
64281,0,0,0,0,0,0
6429,1578,823,6,19,335,2761
64300,568,116,274,11,323,1292
64306,96,8,92,0,2,198
64315,1168,362,409,35,592,2566
64459,207,0,15,10,0,232
64476,0,0,0,0,0,0
6453,655,0,0,1,6,662
6461,3685,210,108,26,50,4079
6471,5783,2362,932,171,2317,11565
6503,0,0,0,0,0,0
6510,9,0,0,0,0,9
6522,6,0,0,0,0,6
6527,0,0,0,0,0,0
6528,0,0,0,0,0,0
6535,2819,1136,389,33,1231,5608
6536,2723,18,150,13,402,3306
6559,275,0,0,0,0,275
6561,621,85,139,5,213,1063
6576,0,0,2,0,0,2
6580,0,0,0,0,0,0
6582,0,0,0,0,0,0
6594,2030,22,21,0,133,2206
6614,175,2,38,3,126,344
6619,0,0,0,0,0,0
6620,0,0,0,0,0,0
6621,91,4,0,3,27,125
6629,78,1,0,0,0,79
6639,0,0,0,0,0,0
6640,313,6,0,10,164,493
6648,12281,86,1903,11,227,14508
6653,0,0,0,0,0,0
6661,6623,11,1129,53,51,7867
6663,0,0,2,0,0,2
668,0,0,0,0,0,0
6697,12280,2897,2182,35,3250,20644
6700,6,0,106,0,748,860
6704,0,0,8,0,0,8
6711,0,0,0,0,0,0
6717,1,0,62,0,0,63
6718,6,0,0,0,8,14
6730,681,0,804,4,4717,6206
6735,1653,0,44,14,157,1868
6739,504,0,471,0,1094,2069
6740,0,0,30,0,18,48
6744,0,1,4,0,0,5
6747,180,10,31,1,28,250
675,0,0,0,0,0,0
6752,0,0,33,4,63,100
6758,0,0,0,0,0,0
6769,709,8,181,0,23,921
6772,0,0,58,0,1166,1224
6789,0,1,11,0,0,12
6799,7655,37,1463,14,755,9924
680,15082,52,1178,12,560,16884
6802,171,2,306,0,4,483
6805,49681,522,4128,98,15881,70310
6829,304,0,6,0,0,310
6830,102704,6658,18478,402,41894,170136
6834,0,17,0,0,0,17
6836,4,0,9,0,0,13
6843,117,1,0,12,44,174
6848,0,0,870,0,0,870
6855,950,2,1072,11,1550,3585
6856,0,106,188,1,0,295
6863,0,1,0,3,0,4
6868,0,1,0,0,0,1
6871,102,0,15,16,0,133
6882,929,151,43,0,31,1154
6908,0,0,20,0,0,20
6910,1052,3,317,0,78,1450
693,0,0,0,0,0,0
6939,3972,210,252,37,869,5340
6994,1024,41,0,0,56,1121
7004,348,378,310,21,217,1274
7005,416,192,13,23,119,763
701,207484,2434,43553,2029,75417,330917
7011,4123,11,48,0,61,4243
7015,2,0,0,0,0,2
7016,480,5,75,9,57,626
7018,528440,9050,5576,3414,104552,651032
702,5698,95,1615,0,2,7410
7029,24171,316,554,77,1941,27059
703,1959,570,0,23,97,2649
7046,37,0,0,2,1,40
7048,2206,14,0,3,120,2343
7049,1707,658,225,77,378,3045
7055,0,0,0,0,0,0
7057,0,0,0,0,0,0
7063,387,15,54,14,11,481
7065,3245,175,192,2,153,3767
7068,7,0,0,0,0,7
7078,0,0,0,0,0,0
7106,667,1,31,0,24,723
7116,0,0,0,0,0,0
7122,0,0,0,0,0,0
7132,2551,16,140,16,120,2843
714,624,0,0,0,1,625
7155,3530,6,8,1,349,3894
7160,0,0,0,0,0,0
7162,826,10,0,16,132,984
719,15014,665,1051,15,2558,19303
72,0,0,0,0,0,0
7202,0,0,0,0,0,0
7203,249,17,0,12,17,295
7212,0,0,0,0,0,0
7226,0,0,0,0,0,0
7250,2051,14,100,7,222,2394
7268,0,0,15,0,0,15
7276,0,0,0,0,0,0
73,512,1,0,0,62,575
7303,44701,11131,4916,1117,11343,73208
7311,797,13,36,2,45,893
7332,0,0,0,0,0,0
7341,0,0,130,0,0,130
7349,4,0,22,0,0,26
7352,0,0,8,3,0,11
7377,111,1,0,0,0,112
7381,11,4,0,0,1,16
7385,11985,664,375,62,659,13745
7386,0,0,0,0,0,0
7393,0,0,0,0,0,0
7403,0,0,49,1,0,50
7418,6517,2763,735,92,2957,13064
7438,0,0,0,0,0,0
7456,0,1,34,7,0,42
7459,0,0,0,0,0,0
7465,871,118,433,0,1,1423
7470,718,8304,425,561,2,10010
7472,570,8,0,0,225,803
7474,7107,1556,658,19,1014,10354
7477,2304,572,125,7,809,3817
7482,15528,416,251,325,139,16659
7489,622,1,0,14,63,700
7497,3319,16,4,0,938,4277
7506,0,1,0,1,0,2
7511,6284,631,27,7,1244,8193
7516,1,18,9,0,0,28
7522,19084,373,454,260,3343,23514
7524,16224,162,49,78,4461,20974
7532,12,0,2,0,0,14
7539,57,0,0,0,0,57
7545,164906,14208,3267,4886,87415,274682
7546,782,515,288,28,335,1948
7552,82033,42197,4603,4978,92454,226265
7557,189,0,0,0,0,189
7558,845,0,0,0,6,851
7560,107,0,2,0,0,109
7562,772,0,98,0,0,870
7573,218,5,0,0,0,223
7575,4560,766,35,17,1022,6400
7577,283,0,0,0,5,288
7582,4,0,0,0,0,4
7600,2144,564,91,16,1317,4132
7602,10143,66,1154,156,750,12269
7604,783,66,0,8,211,1068
7616,1530,848,61,2,89,2530
7633,212,332,238,12,5,799
7650,343,0,0,0,41,384
7651,80,0,9,0,1,90
766,24,0,2,0,49,75
7664,808,25,12,0,68,913
7668,2484,46,17,4,91,2642
7670,6167,116,62,17,829,7191
7671,1684,0,89,28,298,2099
7672,9304,95,19,38,1427,10883
7676,1,0,0,0,0,1
7679,135,8,55,50,579,827
7682,0,0,0,0,0,0
7684,1,0,4,4,17,26
7690,0,0,0,0,0,0
7693,71,804,79,2,0,956
77,27,0,0,0,0,27
7713,45776,33204,738,2960,42942,125620
7725,7,0,0,0,0,7
7726,0,0,0,0,0,0
7735,1061,9,148,2,153,1373
7738,87174,6345,5184,1072,13660,113435
777,148,58,2,18,11,237
7774,242,4,0,0,29,275
7792,0,0,0,0,0,0
7795,11718,381,2241,62,3789,18191
7800,0,0,0,0,0,0
7828,0,1,78,17,0,96
7829,8,0,4,0,63,75
7849,0,0,223,17,0,240
7850,638,1,2,3,5,649
786,339,1,68,0,77,485
7871,0,0,0,0,0,0
7896,0,0,0,0,0,0
792,0,0,0,0,0,0
7922,567784,31411,68250,3941,212979,884365
7925,2251,5,0,0,57,2313
7939,0,0,0,0,0,0
7941,494,3,13,0,79,589
7968,0,0,0,0,0,0
797,0,0,0,0,0,0
7979,0,8,117,0,53,178
7992,0,85,122,0,0,207
8,0,0,0,0,0,0
8001,0,1,38,2,0,41
8002,0,0,131,1,0,132
8008,0,0,0,0,0,0
8014,0,0,0,0,0,0
8025,0,0,0,0,0,0
803,40,0,0,0,0,40
8036,0,0,0,0,0,0
8047,371,18,12,3,82,486
8057,2395,59,39,13,267,2773
8075,96938,19313,1589,2752,12681,133273
808,0,0,0,0,0,0
8092,517,17,211,1,27,773
81,1749,25,18,1,23,1816
8100,347,0,4,13,5,369
8103,0,0,0,0,0,0
8111,641,6,0,0,3,650
812,49876,4813,3754,146,17960,76549
8122,0,0,0,0,0,0
8134,0,0,0,0,0,0
8151,4,3,1549,26,364,1946
8167,94710,14933,4690,629,41845,156807
8190,25,0,31,0,0,56
8194,327,0,0,1,4,332
8218,437,0,0,0,0,437
8220,6919,507,1010,7,102,8545
8224,1110,257,102,7,285,1761
8228,75,0,50,0,18,143
8234,912,3,0,0,0,915
8240,0,0,0,0,0,0
8248,4,0,0,0,0,4
8251,0,0,46,3,4,53
8257,0,0,408,6,3,417
8262,234,0,112,0,353,699
8265,1127,13,160,2,124,1426
8273,4424,636,315,0,461,5836
8285,103,6,17,0,5,131
8286,6,0,130,0,0,136
8290,0,0,32,3,4,39
8323,0,0,100,0,0,100
8326,0,0,76,0,0,76
8331,0,139,101,0,0,240
8334,0,154,96,15,0,265
8339,6138,243,486,5,371,7243
8342,0,32,4,0,0,36
8359,549,1597,343,12,0,2501
8362,0,0,11,0,0,11
8365,1198,0,84,0,75,1357
8368,0,0,2,0,0,2
8369,0,14,36,0,0,50
8371,0,0,0,0,0,0
8374,0,0,152,0,0,152
8376,1,0,92,7,2,102
8390,0,0,118,0,0,118
8395,0,6,4,0,0,10
8399,0,0,27,0,0,27
8400,0,0,1311,56,1408,2775
8402,230,430,270,6,6,942
8412,16,0,432,20,1490,1958
8416,0,0,0,0,0,0
8422,15134,419,1198,10,457,17218
8426,585,8,300,3,0,896
8431,0,0,0,0,23,23
8437,9027,1233,1356,0,127,11743
8445,9178,150,1329,2,799,11458
8447,23697,1997,3269,27,420,29410
8448,3,0,124,0,5,132
8468,1,0,207,0,0,208
8470,0,212,157,0,0,369
8473,15061,785,2060,124,8820,26850
8492,0,85,103,0,0,188
852,110698,4877,5121,470,46529,167695
8530,0,0,91,0,0,91
8542,1701,42,38,2,260,2043
855,33,2,2176,40,0,2251
8559,6900,393,892,11,120,8316
8560,4744,60,260,52,570,5686
8562,1927,48,274,4,14,2267
8569,505,1,0,0,1,507
8570,0,1,110,0,0,111
8586,269,0,0,0,0,269
8595,265,195,219,0,0,679
8607,0,0,0,3,0,3
8612,10390,299,1094,27,2349,14159
8615,0,128,8,0,30,166
8629,0,1,0,0,0,1
8632,0,1,51,0,0,52
8636,0,124,139,0,0,263
8641,236,6,140,7,4,393
8661,198,0,25,0,516,739
8680,194,0,75,1,0,270
8681,1,0,22,0,0,23
87,0,0,15,0,0,15
8708,29,0,4,0,1,34
8717,1371,0,2112,47,6351,9881
8728,0,0,0,0,0,0
8732,0,152,150,2,0,304
8745,0,0,82,0,26,108
8751,597,6,202,1,12,818
8752,5,15,117,0,1,138
8758,55,0,280,11,1715,2061
8764,1101,108,162,25,414,1810
8767,12644,551,1893,55,2588,17731
8771,0,2,150,0,0,152
8774,214,9,475,1,0,699
8778,0,0,2,0,8,10
88,0,0,0,0,0,0
8820,1233,2,293,0,7,1535
8821,1,0,494,6,1532,2033
8823,1880,37,167,0,16,2100
8851,0,0,0,0,0,0
8865,0,0,92,0,0,92
8866,98,0,1478,21,6578,8175
8881,25643,625,3554,75,1169,31066
8887,0,0,50,0,15,65
8896,0,0,0,0,0,0
8902,0,0,0,0,0,0
8905,41,27,102,1,0,171
8913,0,0,6,0,0,6
8926,0,0,2,0,0,2
8937,973,2,12,1,77,1065
8953,8439,884,2181,22,1707,13233
8968,13338,656,1532,4,485,16015
8970,0,0,0,0,0,0
8972,941,0,239,5,127,1312
8978,303,16,36,7,108,470
8983,4,0,0,0,0,4
8990,8,0,252,0,0,260
9,0,0,0,0,0,0
9002,5,0,0,0,0,5
9008,1402,9,247,0,18,1676
9009,13429,1992,653,507,5911,22492
9022,1724,20,18,0,12,1774
9031,0,0,138,0,0,138
9044,0,0,103,0,47,150
9050,47954,3702,2093,35,7616,61400
9063,5725,18,435,4,475,6657
9070,3,0,292,24,1430,1749
9080,0,0,170,0,9,179
91,0,0,0,0,0,0
9104,1002,129,23,0,11,1165
9105,1063,0,170,0,290,1523
9110,213,3,0,2,0,218
9119,3025,10,839,2,226,4102
9122,27,6,0,0,0,33
9123,0,0,15,0,0,15
9125,67,0,304,27,2123,2521
9127,0,0,0,0,35,35
9136,0,0,167,0,0,167
9137,1347,2,169,0,94,1612
9145,0,0,541,0,0,541
9146,1610,44,496,1,31,2182
9150,0,0,162,0,0,162
9158,0,0,1356,0,0,1356
9164,0,5,18,0,0,23
9183,65,0,0,0,0,65
9186,0,0,0,0,0,0
9208,0,0,0,0,0,0
9216,135,0,0,0,0,135
9224,1967,594,237,1,294,3093
9228,31,6,26,0,1,64
9229,7,0,0,0,0,7
9231,4096,9,519,49,547,5220
9264,1197,2,0,7,0,1206
9268,4760,1361,252,8,859,7240
9269,81747,1406,14747,565,40412,138877
9271,4,0,0,0,0,4
9286,187,1,2,0,0,190
9293,4466,9,169,1,408,5053
9299,347345,8082,20720,4313,226456,606916
9304,35191,1790,6397,245,15815,59438
9310,3124,947,250,151,2371,6843
9312,186,0,0,2,26,214
9313,2490,592,177,12,1281,4552
9316,12385,5,78,16,122,12606
9318,108812,222,3566,95,1814,114509
9319,39,0,15,0,75,129
9321,287,0,14,0,0,301
9326,1358,60,24,5,205,1652
9335,2501,345,144,81,448,3519
9340,1305,63,323,7,512,2210
9341,12357,2022,2289,106,4087,20861
9351,12829,101,359,36,3682,17007
9354,7290,177,138,37,1455,9097
9365,2,3,0,4,295,304
9367,0,0,0,0,0,0
9370,0,1,0,4,0,5
9371,1185,52,10,14,60,1321
9374,0,0,0,1,0,1
9378,0,0,0,0,0,0
9381,77320,2434,8211,603,14507,103075
9416,33383,1296,1009,891,836,37415
9419,572,6,115,0,55,748
9422,782,78,2,1,281,1144
9430,1,0,0,1,0,2
9443,22315,4699,1052,470,20681,49217
9444,1421,0,0,0,0,1421
9452,623,0,31,0,2,656
9457,1086,1,0,7,4,1098
9459,24,0,0,0,0,24
9486,0,183,0,5,0,188
9488,570,1,16,0,4,591
9498,5038,8580,872,392,307,15189
9500,281,10,0,0,42,333
9506,18007,2809,1045,554,13072,35487
9524,0,0,0,0,0,0
9526,117,0,2,0,0,119
9530,28,0,0,0,0,28
9531,0,0,0,0,0,0
9533,34,2,0,0,4,40
9534,310,22029,450,562,2,23353
9569,5,0,0,0,0,5
9583,1519,2017,407,32,222,4197
9584,4937,102,50,6,28,5123
9595,6649,845,296,12,1636,9438
9597,0,0,0,0,0,0
9600,0,0,0,0,17,17
9601,0,0,0,0,0,0
9605,6485,58,6,103,1444,8096
9614,11298,51,440,35,3294,15118
9615,7,29,10,16,0,62
9617,11287,443,124,38,8004,19896
9621,0,0,0,1,0,1
9622,7439,26,24,37,1214,8740
9644,9402,16,12,11,15,9456
9647,1,0,0,0,0,1
9649,402,287,41,1,42,773
9650,280,38,0,0,140,458
9652,1153,407,0,0,412,1972
9655,232,2,8,1,0,243
9657,1441,157,143,31,117,1889
9658,407,0,12,0,0,419
9674,12785,228,22,15,633,13683
9676,11851,82,305,161,2,12401
9686,9,0,116,6,0,131
9689,13176,3,82,0,7,13268
9694,0,0,0,1,0,1
9697,3,0,0,0,0,3
9698,0,0,0,0,24,24
9706,0,0,0,0,13,13
9708,0,0,0,0,0,0
9712,2,0,0,1,0,3
9723,959,341,144,0,37,1481
9738,1453,172,0,0,267,1892
9751,59,1,0,0,2,62
9753,58,0,0,0,0,58
9756,5356,0,2,4,13,5375
9757,1918,1,0,0,20,1939
9761,1,0,0,0,0,1
9769,493,0,0,0,2,495
9770,103,0,0,1,265,369
9781,2442,1,164,2,10,2619
9785,288,0,4,0,229,521
9794,394,3,10,0,65,472
9801,25,0,0,0,0,25
9808,41023,4952,2160,162,11490,59787
9811,562,12,0,0,0,574
9812,2156,340,0,0,17,2513
9814,518,0,0,0,0,518
9821,3597,24,1088,1,519,5229
9822,541,117,105,7,53,823
9824,42012,1492,444,291,10717,54956
9829,57510,72937,799,8503,18937,158686
9830,405,80,143,16,30,674
9833,598,6,0,31,237,872
9845,1136,1,2,15,1079,2233
9848,667,0,37,1,193,898
9852,9,0,0,0,0,9
9871,5,0,0,0,0,5
9873,5622,14,420,65,1929,8050
9874,1062,78,2,2,45,1189
9875,284,19,0,10,276,589
9891,253,112,78,0,0,443
9902,3067,261,465,44,491,4328
9903,451,56,126,12,26,671
9905,3760,351,77,13,1077,5278
9908,27954,93,2926,65,9878,40916
9916,1125,88,81,19,15,1328
9919,12113,77,365,59,302,12916
9922,1938,49,29,53,46,2115
9924,30345,1989,986,1429,1753,36502
9927,5435,120,1200,33,1277,8065
9929,8261,328,0,12,191,8792
9930,8,55268,408,1166,437,57287
9931,10265,4050,415,141,2017,16888
9943,23,0,0,6,0,29
9946,352,0,0,1,17,370
9950,156,0,452,0,6,614
9970,152,0,0,0,0,152
9971,3576,0,0,11,16,3603
9976,1,0,8,1,211,221
9978,81,0,0,0,0,81
9981,6,0,0,0,0,6
9989,1216,41,0,11,55,1323
9993,0,1,0,0,0,1
9997,2104,7,19,29,460,2619
